# Locutions interjectives

ainsi soit-il	:LJ
chacun sa croix	:LJ
c’est le moins qu’on puisse dire	:LJ
c’est l’hôpital qui se fout de la charité	:LJ
c’est vraiment l’hôpital qui se fout de la charité	:LJ
a crai	:LJ:i
a voté	:LJ
à bientôt	:LJ
à bon entendeur salut	:LJ
à charge de revanche	:LJ
à d’autres	:LJ
à demain	:LJ
à la bonne vôtre	:LJ
à la lanterne	:LJ
à la prochaine	:LJ
à la revoyance	:LJ
à la revoyure	:LJ
à la tienne	:LJ
à la tienne, étienne	:LJ
à la vôtre	:LJ
à l’abordage	:LJ
à l’aide	:LJ
à moi	:LJ
à nous deux	:LJ
à plus	:LJ
à plus tard	:LJ
à qui tu le dis	:LJ
à ta santé	:LJ
à table	:LJ
à tantôt	:LJ
à tout à l’heure	:LJ
à toute	:LJ
à un de ces quatre	:LJ
à vos marques	:LJ
à vos marques, prêts, partez	:LJ
à vos rangs, fixe	:LJ
à votre santé	:LJ
à votre service	:LJ
âlikoum es-selam	:LJ
ça alors	:LJ
ça marche	:LJ
ça roule	:LJ
ça roule, ma poule	:LJ
ça suffit	:LJ
échec et mat	:LJ|:LN:m
aïe, aïe, aïe	:LJ
adieu berthe	:LJ
age quod agis	:LJ/L
ah ben non	:LJ
ah bon	:LJ
ah là là	:LJ:i
all right	:LJ
aller niquer sa mère	:LJ
allez vous faire foutre	:LJ
allons-y, alonso	:LJ
allons bon	:LJ
ams tram gram	:LJ:i
attache ta tuque	:LJ
au coin	:LJ
au feu	:LJ:i
au gui l’an neuf	:LJ
au hasard, balthazar	:LJ
au plaisir	:LJ
au revoir	:LJ|:LN:m:s
au secours	:LJ:i|:LN:m:i
au temps	:LJ
aux armes	:LJ
aux chiottes	:LJ
aux fines herbes	:LJ
avec joie	:LJ
avec plaisir	:LJ
bande d’abrutis	:LJ:i
bas les armes	:LJ
bas les masques	:LJ
bas les pattes	:LJ
ben coudon	:LJ
ben coudonc	:LJ
ben ouais	:LJ
ben voyons	:LJ
ben voyons donc	:LJ
bien joué callaghan	:LJ:i
bien le bonjour	:LJ
bien ou bien	:LJ
bien reçu	:LJ
bien vu	:LJ
bien vu callaghan	:LJ:i
bienvenue au club	:LJ
big up	:LJ
bisque bisque rage	:LJ
bon anniversaire	:LJ
bon appétit	:LJ
bon bout d’an	:LJ
bon dieu	:LJ|:LN:m
bon dieu de bon dieu	:LJ
bon matin	:LJ:i
bon sang	:LJ
bon sang de bon sang	:LJ
bon sang de bonsoir	:LJ
bon sang mais c’est bien sûr	:LJ
bon vent	:LJ:m|:LN:m:s
bon voyage	:LJ
bon yeux	:LJ
bonjour hi	:LJ
bonne année	:LJ|:LN:f:s
bonne arrivée	:LJ
bonne chance	:LJ
bonne continuation	:LJ
bonne journée	:LJ
bonne mère	:LJ
bonne nuit	:LJ:i
bonne sainte anne	:LJ
bonne soirée	:LJ:i
bonté divine	:LJ
bordel à cul	:LJ
bordel à cul de pompe à merde	:LJ
bordel à cul pompe à merde	:LJ:m
bordel de merde	:LJ:m
bot aux autres	:LJ:i
câline de bine	:LJ
câline de binne	:LJ
c’en est trop	:LJ
c’est cela	:LJ
c’est juste, auguste	:LJ
c’est la meilleure	:LJ
c’est pas possible	:LJ
c’est rien de le dire	:LJ
caca boudin	:LA:e|:LJ
calme ta joie	:LJ
carpe diem	:LJ/L
carpe noctem	:LJ/L
carton plein	:LJ:s
cartons pleins	:LJ:p
cause toujours	:LJ
cause toujours tu m’intéresses	:LJ
chacun pour soi, dieu pour tous	:LJ
chaud devant	:LJ:i
chauffe, marcel	:LJ
chic à	:LJ
circulez y’a rien à voir	:LJ
cool abdoul	:LJ
cool, raoul	:LJ
coquin de sort	:LJ
corps dieu	:LJ
cul sec	:LJ
démerde yourself	:LJ|:LN:m
dans le cul la balayette	:LJ
dans ton cul	:LJ
de bleu	:LJ
de quoi	:LJ
de rien	:LJ
deh mais	:LJ
des clous	:LJ
des couilles	:LJ
des nèfles	:LJ
dieu me damne	:LJ
dieu me pardonne	:LJ
dieu me pignole	:LJ
dieu me tripote	:LJ
dieux du ciel	:LJ
dis donc	:LJ
dites donc	:LJ
doux jésus	:LJ
du balai	:LJ
eh bé	:LJ:i
eh ben	:LJ
en revoir	:LJ
en voiture, simone	:LJ
es-salamou âlikoum	:LJ
et alors	:LJ
et avec ça	:LJ
et comment	:LJ
et encore	:LJ
et maintenant	:LJ
et mon cul, c’est du poulet	:LJ
et ta sœur	:LJ
et toc !	:LJ
et voilà le travail	:LJ
fan de putain	:LJ
fant de pute	:LJ
fatche de con	:LJ:i
faut pas pousser	:LJ
ferme ta gueule	:LJ
fils de garce	:LJ|:LN
foin de	:LJ
fonce, alphonse	:LJ
fouette cocher	:LJ
foutre ciel	:LJ:i
garde à vous	:LJ|:LN:m:i
gardez la monnaie	:LJ
han lan lan	:LJ
haro sur le baudet	:LJ:i|:LN:m
haut les cœurs	:LJ
haut les mains	:LJ
ho hisse	:LJ
homme de peu de foi	:LJ
hors de question	:LJ
hure à	:LJ
il ne m’en chaut	:LJ
in cha’allah	:LJ
inch allah	:LJ
jésus marie joseph	:LJ
jésus, marie, joseph	:LJ
jamais couché, jamais levé	:LJ
je veux mon neveu	:LJ
joual vert	:LJ
joyeuses pâques	:LJ
joyeux anniversaire	:LJ
joyeux noël	:LJ:i|:LN:m
jusqu’au revoir	:LJ:i
la barbe	:LJ:i
la belle affaire	:LJ
la ferme	:LJ
la peau	:LJ
la pièce est tombée	:LJ
la tête de ma mère	:LJ
la vache	:LJ
le con de sa mère	:LJ
le franc est tombé	:LJ
les deux mon capitaine	:LJ:i
les deux mon général	:LJ:i
les deux mon neveu	:LJ:i
ma foi	:LJ
ma parole	:LJ
ma parole d’honneur	:LJ
même combat	:LJ
même pas dans tes rêves les plus fous	:LJ
même pas en rêve	:LJ
madame, monsieur	:LJ
mais bien sûr	:LJ
mais c’est bien sûr	:LJ
mais euh	:LJ
mais oui	:LJ
malheur à	:LJ
marché conclu	:LJ
mautadine de crime binne	:LJ
mea culpa	:LJ:i/L|:LN:m:i/L
mea maxima culpa	:LJ:i/L
meilleurs vœux	:LJ
merci beaucoup	:LJ
merci mon chien	:LJ
merci quand même	:LJ
merdum cacatum	:LJ
miam miam	:LJ
mille mercis	:LJ
minute papillon	:LJ
misère de mes os	:LJ
mon œil	:LJ
mon cœur	:LJ
mon cul	:LJ
mon dieu	:LJ
mon fils	:LJ
mon loup	:LJ
mon père	:LJ
mon vier	:LJ
mords-y l’œil	:LJ
mords-y l’œil, t’auras l’os	:LJ
mort aux vaches	:LJ
motus et bouche cousue	:LJ
mystère et boule de gomme	:LJ|:LN:m:s
nique sa mère	:LJ
nique ta mère	:LJ
nique ta reum	:LJ
no comment	:LJ
no souci	:LJ
nom d’un chien	:LJ
nom d’un p’tit bonhomme	:LJ
nom d’un petit bonhomme	:LJ
nom d’une pipe	:LJ
nom de dieu	:LJ:i
nom de zeus	:LJ:i
nombril du pape	:LJ
non d’un petit bonhomme	:LJ
non mais	:LJ
non merci	:LJ
nota bene	:LJ:i/L
noyeux joël	:LJ:i
oh boy	:LJ
oh fant	:LJ
oh hisse	:LJ
oh hisse, enculé	:LJ
oh là là	:LJ
ouate de phoque	:LJ
ouh là	:LJ
ouh là là	:LJ
ouil you uouil	:LJ:i
par bélénos	:LJ
par jupiter	:LJ
par toutatis	:LJ
parole d’honneur	:LJ|:LN:f:s
parole de scout	:LJ
pas de ça, lisette	:LJ
pas de lézard	:LJ
pas de problème	:LJ
pas de quartier	:LJ
pas de quoi	:LJ
pas de souci	:LJ
pas folle la guêpe	:LJ
pas possible	:LA:e:s|:LJ
pas question	:LJ
pas touche	:LJ
passez muscade	:LJ
passez, muscade	:LJ
pax omnibus	:LJ/L
peu m’en chaut	:LJ
peu me chaut	:LJ
pipi caca	:LA:i|:LJ:i
pis après	:LJ
poil au cul	:LJ
poil au dos	:LJ
poil au nez	:LJ
poil au zizi	:LJ
poil aux dents	:LJ
point barre	:LJ:i
point de rancune	:LJ
point final	:LJ|:LN:m
poisson d’avril	:LJ|:LN:m:s
pou pou pidou	:LJ
pour vous servir	:LJ
première nouvelle	:LJ
proh pudor	:LJ
putain con	:LJ
putain de bordel de merde	:LJ:i
putain de merde	:LJ
putain de sa mère	:LJ
putain de sa race	:LJ
putain de ta race	:LJ
pute borgne	:LJ
qu’es aco	:LJ
qu’es aquo	:LJ
qu’il aille se faire foutre	:LJ
qu’ils aillent se faire foutre	:LJ
que dal	:LJ
que dalle	:LJ
que le grand crique me croque	:LJ
que tu crois	:LJ
qui vive	:LJ:i
r. s. v. p.	:LJ
raison de plus	:LJ
relax max	:LJ
retourne aux asperges	:LJ
room service	:LJ
sa mère	:LJ|:LN
s’il en est	:LJ
s’il te plaît	:LJ
s’il te plait	:LJ
s’il vous plaît	:LJ
s’il vous plait	:LJ
sac à papier	:LJ
sainte vierge	:LJ:f
salut et fraternité	:LJ:m:i
sans adieu	:LJ
sans déc’	:LJ
sans déconner	:LJ
sans rancune	:LJ
seigneur jésus marie joseph	:LJ
si tu savais	:LJ
st st	:LJ
sur la tête de ma mère	:LJ
sursum corda	:LJ:m
ta bouche	:LJ:p
ta gueule	:LJ:p
ta gueule la mouette	:LJ
ta mère	:LJ
ta race	:LJ
ta yeule	:LJ
t’as raison	:LJ
t’es pas transparent	:LJ
tant mieux	:LJ
tant pis, tant mieux	:LJ
tchin tchin	:LJ
tiens donc	:LJ
tirez, tirez	:LJi
ton père n’est pas vitrier	:LJ
tonnerre de brest	:LJ
top chrono	:LJ
tout doux	:LJ
trêve de plaisanterie	:LJ:m
tranquille, émile	:LJ
tranquille, bill	:LJ
troun de l’air	:LJ
tu as raison	:LJ
tu m’étonnes	:LJ
tu m’étonnes, john	:LJ
tu m’en diras tant	:LJ
tu parles	:LJ
tu parles, charles	:LJ
tu vois	:LJ
un homme à la mer	:LJ
un petit beurre, des touyous	:LJ
un peu mon neveu	:LJ
une chance	:LJ
va-t’en voir s’ils viennent	:LJ
va chier	:LJ
va comprendre charles	:LJ
va te faire enculer	:LJ
va te faire foutre	:LJ
va te faire une soupe d’esques	:LJ
vade retro, satana	:LJ/L
vains dieux	:LJ
velci revari-volcet	:LJ
vingt dieux	:LJ:i
vive le roi	:LJ
voilà qui est parler	:LJ
vos gueules	:LJ:s
vos gueules là-dedans	:LJ
vos gueules les mouettes	:LJ
voyons donc	:LJ
voyons voir	:LJ
yercʼh mad	:LJ
youpla boom tagada tsoin tsoin	:LJ
youpla boum tagada tsoin tsoin	:LJ:i|:LN:m:i
zut au berger	:LJ

