# Locutions verbales

abandonner la partie	:LV
abattre du bois	:LV
abattre son jeu	:LV
abonder dans le sens de	:LV
abonder dans son sens	:LV
abonder dans un sens	:LV
aboyer comme un roquet	:LV
aboyer à la lune	:LV
abuser de	:LV
accepter pour argent comptant	:LV
accorder la main de	:LVi
accorder ses violons	:LVi
accuser le coup	:LV
acheminer un cheval	:LV
acheter chat en poche	:LV
acheter la paix sociale	:LV
acheter le chat pour le lièvre	:LV
acheter une conduite	:LV
admettre à sa table	:LV
adopter un profil bas	:LV
adorer le veau d’or	:LV
adresser la parole	:LVi
afficher la couleur	:LV
affuter ses crochets	:LV
affuter ses crocs	:LV
affuter ses gambilles	:LV
affuter ses meules	:LV
affuter ses pincettes	:LV
affuter ses tabourets	:LV
affûter ses crochets	:LV
affûter ses crocs	:LV
affûter ses gambilles	:LV
affûter ses meules	:LV
affûter ses pincettes	:LV
affûter ses tabourets	:LV
agiter le chiffon rouge	:LV
agiter l’épouvantail	:LV
aider à	:LV
aimer autant	:LV
aimer bien	:LVt
aimer de	:LV
aimer mieux	:LVt
aimer que	:LVt
aimer quelqu’un plus que ses yeux	:LV
aimer à	:LV
aimer à la folie	:LV
ajouter de l’huile sur le feu	:LV
ajouter foi	:LVn
ajouter son grain de sel	:LV
ajouter une pierre à l’édifice	:LVi
aller ad patres	:LV
aller au charbon	:LV
aller au fait	:LV
aller au feu	:LV
aller au large	:LVi
aller au paradis	:LV
aller au paradis avec ses souliers	:LV
aller au petit coin	:LV
aller au refil	:LV
aller au schlof	:LV
aller au tapis	:LV
aller au turbin	:LV
aller au-devant par derrière	:LV
aller aux danseuses	:LV
aller aux fraises	:LV
aller aux nouvelles	:LVt
aller aux provisions	:LVi
aller aux putes	:LV
aller aux pâquerettes	:LV
aller aux toilettes	:LV
aller aux vaches	:LV
aller bien	:LVi
aller bon train	:LV
aller bride en main	:LVi
aller chez le bonhomme	:LV
aller comme le vent	:LVi
aller comme les écrevisses	:LV
aller comme sur des roulettes	:LV
aller comme un gant	:LV
aller dans le mur	:LV
aller dans le sens de	:LV
aller dans l’autre monde	:LVi
aller de l’avant	:LV
aller de l’oreille	:LV
aller de pair	:LV
aller de plain	:LV
aller de soi	:LV
aller droit au coeur	:LV
aller droit dans le mur	:LV
aller du même pied	:LV
aller d’un même vent	:LVi
aller d’un pied léger	:LV
aller en enfer	:LV
aller et venir	:LV
aller le droit chemin	:LV
aller le nez au vent	:LVi
aller libérer mandela	:LV
aller loin	:LV
aller loin dans la vie	:LV
aller l’amble	:LV
aller par haut	:LVi
aller plus vite que la musique	:LV
aller plus vite que le vent	:LVi
aller péter dans les fleurs	:LV
aller se faire	:LV
aller se faire chlorophyller	:LV
aller se faire cuire un œuf	:LV
aller se faire empapaouter	:LV
aller se faire enculer	:LV
aller se faire endauffer	:LV
aller se faire fiche	:LV
aller se faire foutre	:LV
aller se faire mettre	:LV
aller se faire pendre ailleurs	:LV
aller se faire rhabiller	:LV
aller se faire voir	:LV
aller se faire voir ailleurs	:LV
aller se faire voir chez les grecs	:LV
aller se rhabiller	:LV
aller selon le vent	:LVi
aller son (petit) bonhomme de chemin	:LV
aller son bonhomme de chemin	:LV
aller son grand chemin	:LV
aller son petit bonhomme de chemin	:LVi
aller sous les fleurs	:LV
aller tout d’un vent	:LVi
aller trop loin	:LV
aller vite en besogne	:LV
aller voir	:LV
aller voir défiler les dragons	:LV
aller à canossa	:LVi
aller à courbette	:LV
aller à crosse	:LV
aller à dame	:LVi
aller à dérive	:LVi
aller à la bouline	:LVi
aller à la braise	:LV
aller à la cour	:LV
aller à la dérive	:LVi
aller à la ligne	:LVi
aller à la selle	:LVi
aller à la soupe	:LV
aller à l’appui de la boule	:LV
aller à l’essentiel	:LV
aller à malle	:LVi
aller à niort	:LV
aller à tous les diables	:LVi
aller à vau-l’eau	:LV
allez voir là-bas si j’y suis	:LV
allez-y	:LV
amener de l’eau au moulin	:LV
amener le pavillon	:LV
amuser la galerie	:LV
amuser le tapis	:LV
amuser l’ennemi	:LV
annoncer la couleur	:LVi
antifler de sec	:LV
aplatir au mur	:LVt
appeler a minima	:LV
appeler de ses vœux	:LVt
appeler le ban et l’arrière ban	:LV
appeler les choses par leur nom	:LV
appeler raoul	:LV
appeler un chat un chat	:LV
appeler à minima	:LV
applaudir des deux mains	:LV
applaudir du bout des doigts	:LV
appliquer ou expliquer	:LV
apporter de l’eau au moulin	:LV
apporter de l’eau à son moulin	:LV
apporter sa pierre à l’édifice	:LV
apporter sur un plateau (d’argent)	:LV
apprendre par cœur	:LV
apprendre à vivre	:LV
appuyer sur le champignon	:LV
arracher les mots de la bouche	:LV
arracher les yeux	:LV
arranger le portrait	:LV
arranger les bidons	:LV
arriver après la bataille	:LV
arriver comme belsunce	:LV
arriver comme le marquis de couille-verte	:LV
arriver comme les carabiniers	:LV
arriver comme un cheveu sur la soupe	:LV
arriver comme un chien dans un jeu de quilles	:LV
arriver comme une fleur	:LV
arriver à bon port	:LV
arriver à la fumée des cierges	:LV
arrondir les angles	:LV
arrondir sa (ses) fin(s) de mois	:LV
arrondir ses fins de mois	:LV
arroser la vendange	:LV
arrêter les frais	:LV
assigner pour voir dire et ordonner	:LV
assigner à résidence	:LV
attacher le grelot	:LV
attacher pierre avec paul	:LV
attacher sa tuque	:LV
attendre après	:LV
attendre au tournant	:LV
attendre avec une brique et un fanal	:LV
attendre comme le messie	:LV
attendre de la famille	:LV
attendre famille	:LV
attendre godot	:LVt
attendre le déluge	:LV
attendre sous l’orme	:LV
attendre un heureux évènement	:LV
attendre un heureux événement	:LV
attraper la balle au bond	:LV
attraper la mort	:LV
au-dessus de ses affaires	:LV
avaler de travers	:LV
avaler des couleuvres	:LV
avaler des poires d’angoisse	:LV
avaler doux comme lait	:LV
avaler la couleuvre	:LV
avaler la dragée	:LV
avaler la grenouille	:LVi
avaler la pilule	:LV
avaler le goujon	:LV
avaler par le trou du dimanche	:LV
avaler sa chaloupe	:LV
avaler sa chiffe	:LV
avaler sa chique	:LV
avaler sa cravate	:LV
avaler sa cuiller	:LV
avaler sa fourchette	:LV
avaler sa langue	:LVi
avaler sa salive	:LV
avaler son extrait de naissance	:LV
avaler tout rond	:LV
avaler un crapaud	:LV
avaler une couleuvre	:LV
avancer au pas d’echternach	:LV
avancer pied à pied	:LV
avoir accès	:LV
avoir affaire à	:LVn
avoir avalé sa langue	:LV
avoir barre	:LV
avoir barres	:LVi
avoir beau	:LV
avoir beau jeu	:LV
avoir besoin de	:LV
avoir bobo	:LV
avoir bon cœur	:LV
avoir bon dos	:LV
avoir bon marché	:LV
avoir bon pied, bon œil	:LV
avoir bonne grâce à	:LV
avoir bonne presse	:LV
avoir bu l’eau des nouilles	:LV
avoir carte blanche	:LV
avoir ce qu’il faut là où il faut	:LVi
avoir cent pieds par-dessus la tête	:LV
avoir chaud aux fesses	:LV
avoir chaud aux oreilles	:LV
avoir connaissance	:LVn
avoir couché avec une grenade	:LV
avoir cours	:LVi
avoir coutume	:LV
avoir cœur au métier	:LVi
avoir dans la main	:LV
avoir dans la peau	:LVt
avoir dans le nez	:LV
avoir dans le sang	:LV
avoir dans sa poche	:LV
avoir de bons et de mauvais quarts d’heure	:LVi
avoir de la bouteille	:LV
avoir de la branche	:LV
avoir de la broue dans le toupet	:LV
avoir de la chance	:LV
avoir de la chatte	:LV
avoir de la conscience	:LVi
avoir de la conversation	:LVi
avoir de la gueule	:LV
avoir de la langue	:LV
avoir de la merde dans les yeux	:LV
avoir de la mine dans le crayon	:LVi
avoir de la misère	:LVi
avoir de la moule	:LV
avoir de la peine à	:LV
avoir de la suite dans les idées	:LV
avoir de la tête	:LVi
avoir de la veine	:LV
avoir de l’allure	:LV
avoir de l’argent devant soi	:LV
avoir de l’eau dans la cave	:LV
avoir de l’empire	:LV
avoir de l’esprit comme un demon	:LV
avoir de l’oreille (musicale)	:LV
avoir de l’œil	:LVi
avoir de qui tenir	:LVi
avoir de quoi	:LV
avoir de quoi (voir venir)	:LV
avoir de ses nouvelles	:LVi
avoir des antennes	:LV
avoir des atomes crochus	:LV
avoir des billes	:LV
avoir des biscuits	:LV
avoir des casseroles au cul	:LV
avoir des casseroles aux fesses	:LV
avoir des cornes	:LV
avoir des couilles	:LV
avoir des couilles au cul	:LV
avoir des doigts de fée	:LV
avoir des fourmis	:LV
avoir des fourmis dans les jambes	:LV
avoir des gaz	:LV
avoir des heures de vol	:LV
avoir des jambes de coq	:LV
avoir des lettres	:LV
avoir des mollets de coq	:LV
avoir des oeillères	:LV
avoir des oreilles chastes	:LVi
avoir des oursins dans les poches	:LV
avoir des sueurs froides	:LV
avoir des vues sur	:LV
avoir des yeux	:LV
avoir des yeux de lynx	:LV
avoir des yeux derrière la tête	:LV
avoir des yeux pour ne pas voir	:LV
avoir des étoiles dans les yeux	:LV
avoir des œillères	:LV
avoir deux mains gauches	:LV
avoir deux paroles	:LV
avoir deux visages	:LV
avoir dormi les doigts dans la prise	:LVi
avoir droit	:LV
avoir droit de cité	:LV
avoir du beurre dans les cheveux	:LVi
avoir du biais	:LV
avoir du bien au soleil	:LV
avoir du biscuit	:LV
avoir du bol	:LV
avoir du chien	:LV
avoir du coffre	:LV
avoir du cran	:LV
avoir du cul	:LV
avoir du culot	:LV
avoir du doigté	:LVi
avoir du flair	:LV
avoir du foin dans ses bottes	:LVi
avoir du front tout le tour de la tête	:LV
avoir du gaz	:LV
avoir du grain à moudre	:LV
avoir du guts	:LV
avoir du mal	:LVi
avoir du métier	:LV
avoir du nez	:LV
avoir du pain sur la planche	:LV
avoir du plomb dans la tête	:LV
avoir du plomb dans l’aile	:LV
avoir du poil au cul	:LV
avoir du pot	:LV
avoir du retard	:LV
avoir du retard à l’allumage	:LV
avoir du sable dans le vagin	:LV
avoir du sang dans les veines	:LV
avoir du sang sur les mains	:LV
avoir du sens	:LV
avoir du souci	:LV
avoir du temps devant soi	:LV
avoir du temps à perdre	:LV
avoir du toupet	:LV
avoir du travail sur la planche	:LV
avoir dur	:LV
avoir déjà donné	:LV
avoir déjà vu neiger	:LV
avoir d’autres chats à fouetter	:LV
avoir en main	:LV
avoir en poche	:LV
avoir encore du lait derrière les oreilles	:LV
avoir envie	:LV
avoir faim	:LV
avoir fait la guerre	:LV
avoir fait son temps	:LV
avoir foi	:LVn
avoir fort à faire	:LV
avoir gardé les cochons ensemble	:LV
avoir grand-peine à	:LV
avoir grand’peine à	:LV
avoir honte	:LVi
avoir horreur	:LV
avoir hâte	:LV
avoir la banane	:LV
avoir la berlue	:LV
avoir la bosse	:LV
avoir la bosse des maths	:LV
avoir la bouche en coeur	:LV
avoir la bouche en feu	:LV
avoir la bouche sucrée	:LV
avoir la bougeotte	:LVi
avoir la boule	:LV
avoir la boule au ventre	:LV
avoir la boule à zéro	:LV
avoir la bride sur le cou	:LV
avoir la broue dans le toupet	:LV
avoir la chair de poule	:LV
avoir la chienne	:LV
avoir la clef des champs	:LV
avoir la conscience large	:LVi
avoir la conscience nette	:LV
avoir la conscience tranquille	:LV
avoir la cote	:LV
avoir la courte haleine	:LVi
avoir la cuisse hospitalière	:LV
avoir la cuisse légère	:LV
avoir la dalle	:LV
avoir la dalle en pente	:LV
avoir la dent	:LV
avoir la dent creuse	:LV
avoir la dent dure	:LV
avoir la forme	:LV
avoir la frite	:LV
avoir la frousse	:LV
avoir la fève	:LV
avoir la gnaque	:LV
avoir la gorge nouée	:LV
avoir la gorge serrée	:LV
avoir la grosse tête	:LV
avoir la grulette	:LV
avoir la gueule dans le cul	:LV
avoir la guigne	:LV
avoir la gâchette facile	:LVi
avoir la haute main	:LV
avoir la honte	:LVi
avoir la langue bien pendue	:LV
avoir la larme à l’œil	:LV
avoir la main	:LV
avoir la main bonne	:LV
avoir la main dure	:LV
avoir la main forcée	:LV
avoir la main heureuse	:LV
avoir la main large	:LV
avoir la main leste	:LV
avoir la main levée sur	:LVt
avoir la main longue	:LV
avoir la main lourde	:LV
avoir la main légère	:LV
avoir la main malheureuse	:LV
avoir la main sûre	:LV
avoir la main verte	:LV
avoir la main à la pâte	:LV
avoir la manière	:LV
avoir la marde au cul	:LV
avoir la morve au nez	:LV
avoir la mèche courte	:LV
avoir la mémoire courte	:LV
avoir la parole	:LV
avoir la parole haute	:LV
avoir la patate	:LV
avoir la peau	:LV
avoir la peau dure	:LV
avoir la peur au ventre	:LV
avoir la poisse	:LV
avoir la puce à (derrière) l’oreille	:LV
avoir la puce à l’oreille	:LV
avoir la pêche	:LVi
avoir la rame	:LV
avoir la reconnaissance du ventre	:LV
avoir la rogne au coude	:LV
avoir la science infuse	:LV
avoir la taupe au guichet	:LV
avoir la tête ailleurs	:LV
avoir la tête comme un compteur à gaz	:LVi
avoir la tête comme un tambour	:LV
avoir la tête dans le cul	:LV
avoir la tête dans le pâté	:LV
avoir la tête dans le sac	:LV
avoir la tête dans les nuages	:LV
avoir la tête de	:LV
avoir la tête de l’emploi	:LV
avoir la tête dure	:LV
avoir la tête d’un déterré	:LVi
avoir la tête en l’air	:LV
avoir la tête fêlée	:LVi
avoir la tête lourde	:LVi
avoir la tête pesante	:LVi
avoir la tête près du bonnet	:LV
avoir la tête sur les épaules	:LV
avoir la vache et le veau	:LV
avoir la vie dure	:LVi
avoir la vue nette	:LV
avoir le ballon	:LVi
avoir le beau rôle	:LV
avoir le bec fin	:LV
avoir le blues	:LV
avoir le boulard	:LV
avoir le bourdon	:LV
avoir le bras long	:LV
avoir le cafard	:LV
avoir le champ libre	:LV
avoir le chapeau sur l’oreille	:LV
avoir le cigare au bord des lèvres	:LV
avoir le coeur bien accroché	:LV
avoir le coeur sur la main	:LV
avoir le compas dans l’oeil	:LV
avoir le compas dans l’œil	:LV
avoir le coup de foudre	:LV
avoir le coup d’œil	:LV
avoir le couteau entre les dents	:LV
avoir le couteau sous la gorge	:LV
avoir le cul bordé de médailles	:LV
avoir le cul bordé de nouilles	:LV
avoir le cul dans le beurre	:LV
avoir le cul entre deux chaises	:LV
avoir le cœur au bord des lèvres	:LV
avoir le cœur au métier	:LVi
avoir le cœur brisé	:LV
avoir le cœur gros	:LV
avoir le cœur sec	:LVi
avoir le cœur serré	:LV
avoir le cœur sur la main	:LVi
avoir le cœur sur la main et le poignet coupé	:LV
avoir le cœur sur les lèvres	:LV
avoir le dernier mot	:LV
avoir le dessous	:LV
avoir le dessus	:LV
avoir le dessus du vent	:LV
avoir le diable au corps	:LV
avoir le dos large	:LV
avoir le droit de cité	:LV
avoir le feu au cul	:LV
avoir le feu au plancher	:LV
avoir le fil	:LV
avoir le front	:LV
avoir le front	:LV
avoir le gaz	:LV
avoir le gosier en pente	:LV
avoir le gosier ferré	:LV
avoir le gosier pavé	:LV
avoir le gosier sec	:LV
avoir le goût	:LV
avoir le grelot	:LV
avoir le gros ventre	:LVi
avoir le meilleur	:LV
avoir le melon	:LV
avoir le moral	:LV
avoir le moral dans les chaussettes	:LV
avoir le moral à zéro	:LV
avoir le mot	:LV
avoir le mot pour rire	:LV
avoir le nez au vent	:LVi
avoir le nez creux	:LV
avoir le nez fin	:LV
avoir le pain et le couteau	:LV
avoir le palais fin	:LV
avoir le papier qui colle aux bonbons	:LV
avoir le pas sur	:LV
avoir le pied marin	:LVi
avoir le pied à l’étrier	:LV
avoir le point	:LV
avoir le porte-monnaie en poil d’hérisson	:LV
avoir le pouce vert	:LVi
avoir le rythme dans la peau	:LV
avoir le sac	:LVi
avoir le sang chaud	:LV
avoir le sang vif	:LVt
avoir le seum	:LV
avoir le souffle coupé	:LV
avoir le swag	:LVi
avoir le tac	:LVi
avoir le temps	:LV
avoir le trou du cul en chou-fleur	:LV
avoir le trouillomètre à zéro	:LV
avoir le vent	:LV
avoir le vent en poupe	:LV
avoir le ventre creux	:LV
avoir le ventre plat comme une punaise	:LV
avoir le verbe facile	:LV
avoir le verbe haut	:LV
avoir le vin triste	:LV
avoir le vire-vire	:LV
avoir les abeilles	:LV
avoir les belles manières	:LV
avoir les bleus	:LV
avoir les boules	:LV
avoir les cartes en main	:LV
avoir les cheveux beurrés	:LVi
avoir les cheveux près de la tête	:LV
avoir les chevilles qui enflent	:LV
avoir les chevilles qui gonflent	:LV
avoir les chocottes	:LV
avoir les coudées franches	:LV
avoir les couilles	:LV
avoir les crocs	:LV
avoir les côtes en long	:LVi
avoir les dents du fond qui baignent	:LV
avoir les dents longues	:LV
avoir les dents mêlées	:LV
avoir les dents qui rayent le parquet	:LV
avoir les dents qui rayent le plancher	:LV
avoir les deux pieds dans le même sabot	:LVi
avoir les deux pieds sur terre	:LV
avoir les deux yeux dans le même trou	:LV
avoir les doigts crochus	:LV
avoir les fils qui se touchent	:LV
avoir les fièvres	:LV
avoir les foies	:LV
avoir les foies (blancs)	:LV
avoir les glandes	:LV
avoir les jambes coupées	:LV
avoir les jambes en parenthèses	:LV
avoir les jetons	:LV
avoir les joues en feu	:LV
avoir les larmes aux yeux	:LVi
avoir les mains dans les poches	:LV
avoir les mains libres	:LV
avoir les mains liées	:LV
avoir les mains nettes	:LV
avoir les mains nettes de	:LV
avoir les mains pleines de pouces	:LV
avoir les mains sales	:LV
avoir les moyens	:LV
avoir les nerfs	:LV
avoir les oreilles bouchées	:LV
avoir les oreilles délicates	:LVi
avoir les oreilles qui sifflent	:LV
avoir les oreilles rebattues	:LV
avoir les patates au fond du sac	:LV
avoir les pieds carrés	:LV
avoir les pieds sur terre	:LV
avoir les portugaises ensablées	:LV
avoir les pouces verts	:LVi
avoir les reins solides	:LV
avoir les rideaux qui collent aux fenêtres	:LV
avoir les seins en gants de toilette	:LV
avoir les yeux de chimène	:LV
avoir les yeux en face des trous	:LV
avoir les yeux en fusil	:LV
avoir les yeux en trou de bite	:LV
avoir les yeux en trou de pine	:LV
avoir les yeux gros de larmes	:LV
avoir les yeux plus gros que le ventre	:LV
avoir les yeux qui sortent de la tête	:LV
avoir les épaules en portemanteau	:LV
avoir lieu	:LVi
avoir lieu de	:LV
avoir l’abricot en folie	:LV
avoir l’air	:LV
avoir l’air con	:LVi
avoir l’air et la chanson de	:LV
avoir l’air fin	:LV:m:s
avoir l’air malin	:LV
avoir l’effet d’une bombe	:LV
avoir l’esprit bandé	:LV
avoir l’esprit d’escalier	:LV
avoir l’esprit enfoncé dans la matière	:LVi
avoir l’esprit mal tourné	:LV
avoir l’esprit net	:LV
avoir l’esprit tordu	:LV
avoir l’esprit tortu	:LV
avoir l’estomac bien accroché	:LV
avoir l’estomac dans les talons	:LV
avoir l’estomac noué	:LV
avoir l’habitude	:LV
avoir l’haleine courte	:LVi
avoir l’heur de	:LV
avoir l’oreille basse	:LVi
avoir l’oreille de	:LVt
avoir l’oreille fine	:LV
avoir l’oreiller étampé dans la face	:LV
avoir l’âme chevillée au corps	:LV
avoir l’âme d’un laquais	:LV
avoir l’échine souple	:LV
avoir l’œil	:LV
avoir l’œil terne	:LV
avoir maille à partir	:LVn
avoir mal	:LV
avoir mal au cœur	:LV
avoir mal aux cheveux	:LVi
avoir mangé de la vache enragée	:LV
avoir mangé du lion	:LV
avoir martel en tête	:LV
avoir mauvaise grâce à	:LV
avoir mauvaise presse	:LV
avoir ni d’yeux ni d’oreilles	:LV
avoir nom	:LV
avoir par-dessus la tête	:LVi
avoir part	:LVi
avoir passé le coin du bois	:LV
avoir payé sa dette à la société	:LV
avoir peur	:LV
avoir pied	:LV
avoir pignon sur rue	:LVi
avoir pitié	:LVn
avoir plein le cul	:LV
avoir plus d’un tour dans son sac	:LV
avoir plus d’une corde à son arc	:LVi
avoir plus facile	:LV
avoir plus grands yeux que grand ventre	:LV
avoir plusieurs casquettes	:LV
avoir plusieurs cordes à son arc	:LVi
avoir pour agréable	:LV
avoir quatre pieds gauches	:LV
avoir quelque chose dans le ventre	:LV
avoir quelque chose à se mettre sous la dent	:LV
avoir quelques heures de vol	:LV
avoir quelqu’un dans le nez	:LV
avoir raison de	:LVt
avoir recours	:LVn
avoir recours à	:LVn
avoir rien à foutre	:LV
avoir sans cesse l’argent à la main	:LV
avoir ses anglais	:LV
avoir ses bibittes	:LV
avoir ses coudées franches	:LV
avoir ses habitudes	:LVn
avoir ses invités	:LVi
avoir ses ours	:LV
avoir ses têtes	:LV
avoir soif	:LVi
avoir soin de	:LV
avoir son cours	:LV
avoir son dit et son dédit	:LV
avoir son jeune homme	:LVi
avoir son mot à dire	:LV
avoir son pain cuit	:LV
avoir son plein	:LV
avoir son rond de serviette	:LV
avoir son voyage	:LV
avoir sous la main	:LV
avoir sur le bord des lèvres	:LVt
avoir sur le cœur	:LV
avoir sur les bras	:LVt
avoir sur les lèvres	:LVt
avoir sur les oreilles	:LVi
avoir table ouverte	:LV
avoir toujours un pied en l’air	:LV
avoir tout faux	:LV
avoir tout pour plaire	:LV
avoir tout son bon sens	:LV
avoir tout vu	:LV
avoir tout à bauge	:LV
avoir toute honte bue	:LV
avoir toute sa tête	:LVi
avoir toutes les cartes en main	:LV
avoir toutes les peines du monde à	:LV
avoir trait à	:LV
avoir trouvé son permis de conduire dans une boîte de cracker jack	:LV
avoir tôt fait de	:LV
avoir un appétit d’oiseau	:LV
avoir un balai dans le cul	:LV
avoir un baobab dans la main	:LV
avoir un bon départ	:LV
avoir un caillou dans sa chaussure	:LV
avoir un chat dans la gorge	:LV
avoir un cheveu sur la langue	:LV
avoir un coeur d’artichaut	:LV
avoir un coup dans le nez	:LV
avoir un coup dans l’aile	:LV
avoir un coup de foudre	:LV
avoir un coup de marteau	:LV
avoir un cœur de pierre	:LV
avoir un cœur d’artichaut	:LV
avoir un deuxième bureau	:LV
avoir un faible pour	:LVt
avoir un fil à la patte	:LV
avoir un grain	:LV
avoir un mal de chien	:LV
avoir un métro de retard	:LV
avoir un nez à piquer des gaufrettes	:LV
avoir un nom à coucher dehors	:LV
avoir un nom à coucher dehors avec un billet de logement	:LV
avoir un oursin dans sa poche	:LV
avoir un petit creux	:LV
avoir un petit vélo dans la cafetière	:LV
avoir un petit vélo dans la tête	:LV
avoir un pied dans la fosse	:LVi
avoir un pied dans la tombe	:LV
avoir un poil dans la main	:LV
avoir un pois chiche à la place du cerveau	:LV
avoir un polichinelle dans le tiroir	:LVi
avoir un pète au casque	:LV
avoir un second bureau	:LV
avoir un ticket	:LV
avoir un train de retard	:LV
avoir un train à prendre	:LV
avoir un verre dans le nez	:LVi
avoir un égo démesuré	:LV
avoir un œil qui dit merde à l’autre	:LV
avoir un œil qui dit zut à l’autre	:LV
avoir une araignée au plafond	:LV
avoir une araignée au plafond	:LV
avoir une araignée dans la coloquinte	:LV
avoir une araignée dans le plafond	:LV
avoir une bite à la place du cerveau	:LV
avoir une bonne descente	:LV
avoir une bonne presse	:LV
avoir une bonne tête	:LVi
avoir une brioche au four	:LVi
avoir une brique dans le ventre	:LV
avoir une case de vide	:LV
avoir une case en moins	:LV
avoir une cervelle de moineau	:LV
avoir une chance de cocu	:LV
avoir une coquetterie dans l’œil	:LV
avoir une dent contre	:LV
avoir une dent contre quelqu’un	:LV
avoir une faim de loup	:LV
avoir une grande gueule	:LV
avoir une grosse tête	:LV
avoir une idée derrière la tête	:LV
avoir une longueur d’avance	:LV
avoir une mauvaise presse	:LV
avoir une mémoire de poisson rouge	:LV
avoir une mémoire d’éléphant	:LV:f
avoir une oreille qui traîne	:LV
avoir une peur bleue	:LVi
avoir une pierre à la place du cœur	:LV
avoir une plume dans le cul	:LV
avoir une succursale	:LV
avoir une tête de vainqueur	:LV
avoir une tête d’ange	:LV
avoir une tête et des jambes	:LV
avoir une tête à taper dedans	:LV
avoir vent	:LV
avoir vent et marée	:LVi
avoir voix au chapitre	:LV
avoir vu le loup	:LV
avoir vécu	:LVi
avoir à	:LV
avoir à cœur	:LV
avoir à faire	:LV
avoir à la bonne	:LV
avoir à la chouette	:LV
avoir à l’oeil	:LV
avoir à l’usure	:LV
avoir à l’œil	:LV
avoir à voir	:LV
avoir élevé les cochons ensemble	:LV
avoir été bercé trop près du mur	:LV
avoir été démoulé trop chaud	:LV
bader la figue	:LV
baigner dans l’huile	:LV
bailler aux corneilles	:LVi
bailler belle	:LVi
baiser comme un lapin	:LV
baiser fanny	:LV
baiser le cul du diable quand il est frette	:LV
baiser les mains à	:LV
baiser les pouces en croix	:LV
baisser d’un ton	:LV
baisser la garde	:LV
baisser la tête	:LV
baisser les bras	:LV
baisser l’oreille	:LVi
baisser pavillon	:LVi
baisser sa culotte	:LV
baisser son froc	:LV
baisser son pantalon	:LV
balancer la purée	:LV
balancer la sauce	:LV
balayer devant sa porte	:LV
balayer d’un revers de la main	:LV
balayer d’un revers de main	:LV
bander comme un cerf	:LV
bander comme un taureau	:LV
bander comme un turc	:LV
bander comme un âne	:LV
bander mou	:LV
baptiser au sécateur	:LV
barrer le chemin	:LVn
battre comme plâtre	:LV
battre de l’aile	:LV
battre des cils	:LVi
battre des entrechats	:LV
battre des mains	:LVi
battre des paupières	:LVi
battre en arrière	:LV
battre en brèche	:LVt
battre en retraite	:LV
battre froid	:LV
battre la breloque	:LV
battre la caisse	:LV
battre la campagne	:LV
battre la chamade	:LV
battre la charge	:LV
battre la gigue	:LV
battre la grosse caisse	:LV
battre la mer	:LV
battre la mesure	:LV
battre la plaine	:LV
battre la poudre à courbettes	:LVi
battre la semelle	:LV
battre le ban	:LVi
battre le beurre	:LVi
battre le briquet	:LVi
battre le chien devant le loup	:LV
battre le fer	:LV
battre le fer quand il est chaud	:LV
battre le pavé	:LV
battre le pays	:LV
battre le rappel	:LVi
battre le rythme	:LV
battre le tambour	:LV
battre les atouts	:LV
battre les blancs en neige	:LV
battre les buissons	:LV
battre les murs	:LV
battre l’eau	:LV
battre l’eau avec un bâton	:LV
battre l’eau dans un mortier	:LV
battre l’estrade	:LV
battre monnaie	:LV
battre pavillon	:LV
battre quelqu’un comme plâtre	:LV
battre sa coulpe	:LV
battre sa nourrice	:LV
battre son plein	:LV
battre un entrechat	:LV
battre une place	:LV
battre à la main	:LV
battre à plate couture	:LV
battre à plates coutures	:LV
bayer aux corneilles	:LVi
bayer aux grues	:LVi
beurrer la raie	:LV
bien fournir la carrière	:LV
bien gagner	:LVt
bien vouloir	:LV
bivouaquer dans la crevasse	:LV
blanchir sous le harnais	:LV
body surfing	:LV
boire comme un trou	:LV
boire comme un évier	:LV
boire comme une éponge	:LV
boire cul sec	:LV
boire du petit lait	:LV
boire du petit-lait	:LV
boire la coupe jusqu’à la lie	:LV
boire la mer et les poissons	:LV
boire la tasse	:LV
boire le bouillon	:LV
boire le calice	:LV
boire le calice jusqu’à la lie	:LV
boire le coup de l’étrier	:LV
boire le styx	:LV
boire le vin de l’étrier	:LV
boire les paroles	:LV
boire les paroles de	:LV
boire les paroles de quelqu’un	:LV
boire sec	:LV
boire tout son soûl	:LV
boire un coup	:LV
boire un verre de trop	:LVi
boire à petits coups	:LV
boire à tire-larigot	:LV
boiter bas	:LVi
boiter de l’oreille	:LV
bomber la poitrine	:LV
bomber le thorax	:LV
bomber le torse	:LV
border en louvelle	:LV:f
botter en touche	:LV
botter le cul	:LVi
botter le train	:LV
botter les fesses	:LV
boucler la boucle	:LV
bouffer du curé	:LVi
bouffer du lapin	:LV
bouffer du lion	:LV
bouffer la chatte	:LV
bouffer la feuille	:LV
bouffer la feuille de match	:LV
bouffer la grenouille	:LVi
bouffer la tête	:LVt
bouffer le nez	:LV
bouffer les pissenlits par la racine	:LV
bouger d’un pouce	:LV
bouger une oreille	:LV
bourrer la pipe	:LVn
bourrer le crâne	:LV
bourrer le mou	:LV
boutonner dimanche avec lundi	:LV
boutonner mardi avec mercredi	:LV
boutonner samedi avec dimanche	:LV
branler au manche	:LVi
branler dans le manche	:LVi
branler du chef	:LV
braquer les projecteurs	:LV
braquer tout	:LV
brasser de l’air	:LV
brasser du vent	:LV
brider l’ancre	:LVi
briller par son absence	:LV
briser en mille morceaux	:LV
briser la glace	:LV
briser le cœur	:LVt
briser les couilles	:LV
briser les noix	:LV
brosser dans le sens du poil	:LV
brouiller les cartes	:LV
brouiller les pistes	:LV
brouter le gazon	:LV
brouter les couilles	:LV
brouter les pissenlits par la racine	:LV
broyer du noir	:LV
bruler la chandelle par les deux bouts	:LV
bruler le dur	:LV
bruler un feu	:LV
brûler de l’encens devant quelqu’un	:LV
brûler la cervelle	:LVp
brûler la chandelle par les deux bouts	:LV
brûler la politesse	:LV
brûler le dur	:LV
brûler le pavé	:LV
brûler les lèvres	:LV
brûler les planches	:LV
brûler les étapes	:LVi
brûler ses vaisseaux	:LV
brûler un cierge	:LV
brûler un feu	:LV
brûler une carte	:LV
brûler vif	:LV
bâiller à s’en décrocher la mâchoire	:LVi
bâtir des châteaux en espagne	:LV
bâtir des plans sur la comète	:LV
bâtir sur la roche vive	:LV
bâtir sur le roc	:LV
bâtir sur un vif fonds	:LV
bâtir à chaux et à sable	:LV
cacher la poussière sous le tapis	:LV
cacher son jeu	:LV
caler la voile	:LV
calmer le jeu	:LV
calmer son jeu	:LV
caresser dans le sens du poil	:LV
caresser la bouteille	:LV
carrer dans l’oignon	:LV
casser du sucre sur le dos	:LV
casser du sucre sur le dos de quelqu’un	:LV
casser la baraque	:LVi
casser la cabane	:LVi
casser la croute	:LV
casser la croûte	:LV
casser la dalle	:LV
casser la graine	:LV
casser la gueule	:LV
casser la gueule à	:LV
casser la tête	:LVn
casser le morceau	:LV
casser le nez à coups d’encensoir	:LV
casser le pot	:LV
casser les boules	:LV
casser les burnes	:LV
casser les couilles	:LV
casser les oreilles	:LV
casser les pieds	:LV
casser maison	:LV
casser sa pipe	:LV
casser son cou	:LV
casser une graine	:LV
causer de la pluie et du beau temps	:LV
cesser le feu	:LV
changer de braquet	:LV
changer de cheval au milieu du gué	:LV
changer de crèmerie	:LV
changer de crémerie	:LV
changer de disque	:LV
changer de logiciel	:LV
changer de main	:LV
changer de pas	:LV
changer de peau	:LV
changer de ton	:LV
changer de visage	:LV
changer d’air	:LVi
changer d’amures	:LV
changer d’avis comme de chemise	:LV
changer la donne	:LV
changer son fusil d’épaule	:LV
chanter comme une casserole	:LV
chanter comme une gamelle	:LV
chanter comme une guimbarde	:LV
chanter faux	:LV
chanter la messe en breton	:LV
chanter la palinodie	:LVi
chanter manon	:LV
charger la barque	:LV
charger la mule	:LV
charger pour beaucaire	:LVi
charrier droit	:LV
chasser le dragon	:LVi
chasser sur les terres d’autrui	:LV
chasser à la fouée	:LV
chatouiller les moustaches	:LV
chauffer la place	:LV
chauffer les fesses	:LV
chauffer les oreilles	:LV
chauffer les oreilles à quelqu’un	:LV
chauffer à blanc	:LV
chausser le brodequin	:LV
chavirer dans le vétiver	:LV
chavirer dans le vétyver	:LV
chercher chicane	:LVi
chercher des bibittes	:LV
chercher des crosses	:LVi
chercher des noises	:LV
chercher des poux	:LV
chercher des poux dans la tête	:LVn
chercher des verges pour se faire battre	:LV
chercher garouille	:LV
chercher la corde à tourner le vent	:LV
chercher la petite bête	:LV
chercher le poil dans l’œuf	:LV
chercher midi à quatorze heures	:LV
chercher noise	:LV
chercher plus loin que le bout de son nez	:LV
cherchez la femme	:LV
chier comme un maçon	:LV
chier dans la colle	:LV
chier dans les bottes	:LV
chier dans ses culottes	:LV
chier dans son froc	:LV
chier des bulles	:LV:m
chier du poivre	:LV
chier pour la marine	:LV
chier une pendule	:LV
choisir entre la peste et le choléra	:LV
choper la cerise	:LVi
cirer les bottes	:LV
cirer les pompes	:LV
ciseler les joyaux	:LV
claquer dans les pattes	:LV
claquer des dents	:LV
claquer du bec	:LV
claquer entre les doigts	:LV
claquer la porte	:LV
claquer les dents	:LV
cligner de l’œil	:LV
cligner des yeux	:LV
clin d’œiller	:LVit
clouer au pilori	:LVt
clouer le bec	:LVn
cogner des clous	:LV
coiffer au poteau	:LV
coiffer sainte catherine	:LV
coiffer sainte-catherine	:LVi
coiffer sur le poteau	:LV
coincer la bulle	:LV
coller au cul	:LV
coller au pare-chocs	:LV
coller aux basques	:LVt
coller aux semelles	:LVt
coller une patate	:LV
commencer de	:LVt
commencer à	:LVt
commencer à bien faire	:LV
comparer des choux et des carottes	:LV
compenser carbone	:LV
comprendre sa douleur	:LV
comprendre à demi-mot	:LV
compte là-dessus	:LV
compter les clous de la porte	:LV
compter les moutons	:LV
compter pour du beurre	:LVi
compter ses pas	:LV
compter sur	:LV
compter à rebours	:LV
confondre vitesse et précipitation	:LV
connaitre comme le fond de sa poche	:LV
connaitre comme sa poche	:LV
connaitre la chanson	:LV
connaitre quelque chose comme le fond de sa poche	:LV
connaitre quelque chose comme sa poche	:LV
connaître au sens biblique du terme	:LVt
connaître comme le fond de sa poche	:LV
connaître comme sa poche	:LV
connaître de vue	:LV
connaître la chanson	:LV
connaître la musique	:LV
connaître le terrain	:LV
connaître quelque chose comme le fond de sa poche	:LV
connaître quelque chose comme sa poche	:LV
connaître ses classiques	:LV
conserver sa tête	:LVi
conter des pipes	:LV
conter fleurette	:LV
conter florette	:LV
continuer son bonhomme de chemin	:LV
contrôler la famille	:LV
convenir de ses faits	:LV
convoler en justes noces	:LV
convoquer le ban et l’arrière ban	:LV
copier coller	:LN|:LV
corner aux oreilles	:LVn
corner aux oreilles de quelqu’un	:LVn
corriger la fortune	:LV
corrompre la cire	:LV
corrompre le fer	:LV
corrompre les cartons	:LV
corrompre les coupeaux	:LV
corrompre l’eau	:LV
coucher en fosses	:LVt
coucher en joue	:LV
coucher gros	:LVi
coucher sur la paille	:LVi
coucher à la belle étoile	:LV
coudre la peau du renard à celle du lion	:LV
couler bas	:LV
couler comme une champlure	:LV
couler de l’eau sous les ponts	:LV
couler de source	:LV
couler des jours heureux	:LV
couler des jours tranquilles	:LV
couler entre les doigts	:LV
couler un bronze	:LV
couler une bielle	:LV
couler à pic	:LV
couper au court	:LVi
couper au gros	:LV
couper bras et jambes	:LV
couper court	:LVi
couper dans le vif	:LV
couper en deux	:LV
couper la chique	:LV
couper la parole	:LV
couper la poire en deux	:LV
couper le cordon	:LV
couper le mal à la racine	:LV
couper le sifflet	:LV
couper les cheveux en quatre	:LV
couper les coins ronds	:LV
couper les oreilles	:LV
couper les ponts	:LV
couper les vivres	:LV
couper l’herbe sous le pied	:LV
couper sec	:LV
courber la tête	:LV
courber l’échine	:LVi
courir après	:LV
courir après les cotillons	:LVi
courir bord sur bord	:LV
courir comme un dératé	:LV
courir comme un zèbre	:LV
courir deux lièvres à la fois	:LV
courir la fortune du pot	:LVi
courir la gueuse	:LV
courir la poste	:LVi
courir la pretantaine	:LV
courir la pretentaine	:LV
courir la prétantaine	:LV
courir le cotillon	:LVi
courir le garou	:LV
courir le guilledou	:LVi
courir le risque	:LVi
courir les jupons	:LVi
courir les rues	:LV
courir plusieurs lièvres	:LV
courir plusieurs lièvres à la fois	:LV
courir sur le haricot	:LV
courir sur le marché des autres	:LV
courir sur l’haricot	:LV
courir sus	:LVn
courir à perdre haleine	:LV
courir à toute vitesse	:LV
couronner le tout	:LV
couter la peau des couilles	:LV
couter la peau du cul	:LV
couter les yeux de la tête	:LV
couter une blinde	:LV
couver des yeux	:LV
couver du regard	:LV
couvrir de fleurs	:LVt
couvrir sa marche	:LV
coûter bonbon	:LV
coûter cher	:LV
coûter la peau des couilles	:LV
coûter la peau des fesses	:LV
coûter la peau du cul	:LV
coûter la peau du dos	:LV
coûter les yeux de la tête	:LV
coûter un bras	:LV
coûter un rein	:LV
coûter une blinde	:LV
coûter une couille	:LV
cracher au bassinet	:LV
cracher dans la soupe	:LV
cracher en l’air	:LV
cracher le morceau	:LV
cracher leurs poumons	:LV:p
cracher sa pastille valda	:LV
cracher sa valda	:LV
cracher ses poumons	:LV:s
cracher son venin	:LV
cracher à l’esquipot	:LVt
craquer son slip	:LVi
cravacher le pur-sang	:LV
creuser sa fosse	:LVn
creuser sa fosse avec les dents	:LVi
creuser un abîme sous les pas de quelqu’un	:LV
crever la dalle	:LV
crever la gueule ouverte	:LV
crever le plafond	:LV
crever le tympan	:LV
crever les yeux	:LV
crever l’abcès	:LV
crier au loup	:LV
crier au martyre	:LV
crier au meurtre	:LV
crier au perdu	:LVi
crier aux armes	:LVi
crier comme si on l’écorchait	:LVi
crier comme un aigle	:LV
crier comme un aveugle qui a perdu son bâton	:LVi
crier comme un beau diable	:LVi
crier comme un enragé	:LVi
crier comme un fou	:LVi
crier comme un perdu	:LVi
crier comme un putois	:LV
crier dans le désert	:LV
crier famine	:LV
crier famine sur un tas de blé	:LVi
crier grâce	:LV
crier haro sur	:LV
crier misère	:LV
crier miséricorde	:LV
crier sur les toits	:LV
crier victoire	:LV
crier à pleine tête	:LVi
crier à tue-tête	:LVi
crisser la paix	:LV
crisser le feu	:LV
croire au père noël	:LV:m
croire avoir trouvé la pie au nid	:LVi
croire bon	:LV
croire dur comme fer	:LV
croire sur parole	:LVt
croiser le fer	:LVi
croiser les doigts	:LV
croitre en beauté	:LV
croitre en sagesse	:LV
croitre en vertu	:LV
croquer la pomme	:LV
croquer le marmot	:LVi
croître en beauté	:LV
croître en sagesse	:LV
croître en vertu	:LV
créer de toutes pièces	:LV
créer un climat	:LV
cueillir des lauriers	:LV
cueillir la pomme	:LV
cuire du linge	:LV
cuire à petit feu	:LV
cuisiner à petit feu	:LV
cuver son vin	:LV
céder la place	:LVn
céder le pas	:LV
c’en est fait de	:LVm
c’est y pas	:LV:i
c’est-y	:LV
c’est-y pas	:LV
c’est-y-pas	:LV:i
c’est’y pas	:LV:i
damer le pion	:LVt
danser devant le buffet	:LV
danser le branle du loup	:LV
danser les jolivettes	:LV:f:p
danser sur un volcan	:LV
dater de loin	:LVi
demander asile	:LV
demander en grâce	:LV
demander grâce	:LV
demander la lune	:LV
demander la main de	:LV
demander la parole	:LV
demander la passade	:LVi
demander la vie	:LVi
demander pardon	:LV
demander raison	:LVi
demeurer bouche béante	:LV
demeurer bouche bée	:LV
demeurer en arrière	:LV
demeurer en chemin	:LV
demeurer en reste	:LV
demeurer sur le carreau	:LVi
descendre au tombeau	:LV
descendre dans la rue	:LV
descendre dans l’arène	:LV
descendre d’un cran	:LV
descendre en flammes	:LVi
descendre en rappel	:LV
descendre la pente	:LV
descendre quelqu’un de son piédestal	:LV
devenir chèvre	:LV
devenir invisible	:LV
devenir rare	:LV
devenir à rien	:LV
devoir une fière chandelle	:LV
devoir une fière chandelle à quelqu’un	:LV
devoir être écrit gravé en lettres d’or	:LV
dire adieu	:LVn
dire adieu à	:LVn
dire amen	:LV
dire au revoir	:LV
dire ce qu’on a sur la conscience	:LVi
dire ce qu’on a sur le cœur	:LV
dire deux mots	:LV
dire deux mots à l’oreille	:LV
dire du mal	:LV
dire grâces avant le bénédicité	:LV
dire la bonne aventure	:LV
dire quelque chose	:LV
dire quoi	:LV
dire sa râtelée	:LV
dire ses quatre vérités	:LVt
dire son fait	:LVn
dire un mot à l’oreille	:LVi
dire « tu »	:LV
dis tout de suite que	:LV
discuter de tout et de rien	:LV
discuter du sexe des anges	:LV
discuter le bout de gras	:LV
discuter le coup	:LV
disparaître dans la nature	:LV
disparaître de la circulation	:LV
disposer de	:LVt
disputer le terrain	:LV
diviser pour mieux régner	:LVi
diviser pour régner	:LVi
donner acte	:LV
donner assignation	:LVi
donner assurance	:LVi
donner attention	:LVi
donner avec usure	:LVt
donner carrière	:LV
donner carte blanche	:LV
donner chasse	:LVt
donner congé	:LVi
donner corps	:LV
donner corps à	:LV
donner cours	:LV
donner créance	:LVi
donner dans	:LVt
donner dans la bosse	:LV
donner dans le panneau	:LVi
donner dans le piège	:LVi
donner dans l’œil	:LVi
donner de la confiture à des cochons	:LV
donner de la confiture à un cochon	:LV
donner de la voie	:LV
donner de la voix	:LV
donner de l’oreille	:LV
donner dedans	:LVi
donner des ailes	:LV
donner des bornes	:LVi
donner des boutons	:LV
donner des deux	:LVi
donner des limites	:LVi
donner des marques	:LVi
donner des preuves	:LVi
donner des signes d’embarras	:LVi
donner des signes d’impatience	:LVi
donner des signes d’inquiétude	:LVi
donner des soins	:LV
donner des témoignages	:LVi
donner des éperons	:LVi
donner du biscuit	:LV
donner du fil à retordre	:LV
donner du grain à moudre	:LV
donner du mou	:LV
donner du temps au temps	:LV
donner d’une main et retenir de l’autre	:LV
donner en mariage	:LVt
donner en pâture	:LV
donner exemple	:LVi
donner froid dans le dos	:LV
donner gagné	:LVi
donner haleine	:LV
donner la bande	:LV
donner la botte aux puces	:LV
donner la brebis à garder au loup	:LV
donner la béquée	:LV
donner la comédie	:LV
donner la cotte verte à	:LV
donner la cotte verte à une femme	:LV
donner la cotte verte à une fille	:LV
donner la dernière main	:LV
donner la dernière main à	:LV
donner la jaunisse	:LV
donner la main	:LV
donner la main à	:LV
donner la meute	:LVi
donner la mort	:LV
donner la passade	:LVi
donner la pièce	:LVn
donner la vie	:LVi
donner le bal à quelqu’un	:LV
donner le bon dieu sans confession	:LV
donner le bourdon	:LV
donner le bouton	:LV
donner le branle	:LV
donner le bras	:LV
donner le bâton pour se faire battre	:LV
donner le cerf aux chiens	:LVi
donner le change	:LV
donner le change à quelqu’un	:LV
donner le coup de jarnac	:LV
donner le départ	:LV
donner le feu vert	:LV
donner le fil	:LV
donner le go	:LV
donner le jardin	:LV
donner le jardin à un oiseau de proie	:LV
donner le jour	:LV
donner le la	:LV
donner le sein	:LV
donner le signal	:LV
donner le ton	:LV
donner les chiens	:LVi
donner les mains à	:LV
donner libre cours	:LV
donner lieu	:LVi
donner loisir	:LVn
donner l’alerte	:LV
donner l’eau à la bouche	:LVn
donner l’exemple	:LVi
donner l’ordre	:LVn
donner l’éveil	:LVi
donner matière	:LV
donner matière à faire	:LVi
donner naissance	:LV
donner naissance à	:LV
donner occasion	:LVi
donner pour femme	:LVt
donner pour épouse	:LVt
donner pour époux	:LVt
donner pratique	:LVn
donner prise	:LV
donner raison	:LV
donner sa langue au chat	:LV
donner sa langue au chien	:LV
donner sa main à	:LV
donner sa parole	:LV
donner signe de vie	:LV
donner son congé	:LV
donner son feu vert	:LVn
donner suite	:LV
donner sujet	:LVi
donner sur les oreilles	:LVi
donner tête baissée	:LV
donner un coup de canif dans le contrat	:LV
donner un coup de fer	:LV
donner un coup de fil	:LVn
donner un coup de main	:LV
donner un coup de patte à quelqu’un	:LV
donner un coup de pied	:LV
donner un coup de pied dans la fourmilière	:LV
donner un coup de pouce	:LV
donner un coup de rabot	:LV
donner un coup de téléphone	:LVn
donner un coup d’épaule	:LV
donner un coup d’épée dans l’eau	:LV
donner un os à ronger	:LVn
donner une demi-bande	:LV
donner une entorse	:LV
donner une leçon	:LV
donner à bail	:LVt
donner à cens	:LVt
donner à courir	:LVi
donner à deviner	:LVt
donner à entendre	:LVi
donner à ferme	:LVt
donner à l’essai	:LVt
donner à manger	:LVn
donner à penser	:LVi
donner à pleines mains	:LV
donner à rire	:LVi
donner à songer	:LVi
donner à travailler	:LVi
dorer la pilule	:LV
dormir au gaz	:LV
dormir comme un bébé	:LV
dormir comme un loir	:LV
dormir comme un sabot	:LV
dormir comme un sonneur	:LV
dormir comme une loutre	:LV
dormir comme une marmotte	:LV
dormir comme une masse	:LV
dormir comme une pierre	:LV
dormir comme une souche	:LVi
dormir debout	:LV
dormir du sommeil du juste	:LV
dormir d’un somme	:LV
dormir en chien de fusil	:LV
dormir les yeux ouverts	:LVi
dormir sur la switch	:LV
dormir sur les deux oreilles	:LV
dormir sur ses deux oreilles	:LV
dormir sur ses lauriers	:LV
dormir à la belle étoile	:LV
dormir à poings fermés	:LV
doré sur tranche	:LV
doubler la mise	:LV
dresser les oreilles	:LV
dresser l’oreille	:LV
droit de regard	:LV
dropper le djebel	:LV
du goudron et des plumes	:LV
durer trois plombes	:LV
durer une éternité	:LV
débarrasser le plancher	:LV
déblayer le terrain	:LV
débroussailler la tranchée	:LV
décerner la palme	:LV
décharger son cœur	:LV
déchirer le coeur	:LV
déchirer à belles dents	:LV
déclarer forfait	:LV
déclarer la guerre	:LV
découper au chalumeau	:LV
découvrir la lune	:LV
découvrir le pot aux roses	:LV
découvrir pierre pour couvrir paul	:LVi
découvrir que l’eau mouille	:LV
découvrir saint pierre pour couvrir saint paul	:LVi
découvrir son jeu	:LVi
découvrir une pièce	:LVi
décrocher la lune	:LV
décrocher la timbale	:LV
décrocher le pompon	:LV
défendre la curée	:LV
défendre la veuve et l’orphelin	:LV
défendre le dernier carré	:LV
défendre son bifteck	:LV
défiler à la queue leu-leu	:LV
défleurir les haies	:LV
défrayer la chronique	:LVi
dégringoler un pante	:LV
démarrer au quart de tour	:LVi
démontrer par a + b	:LV
déménager à la cloche de bois	:LV
déménager à la ficelle	:LV
démêler l’écheveau	:LV
dépasser les bornes	:LV
dépenser sa salive pour rien	:LV
déplacer des montagnes	:LV
déplorer que la mariée soit trop belle	:LV
déposer le bilan	:LVi
déposer les armes	:LV
déposer son bilan	:LV
déposer une plainte	:LV
dépoter le gluant	:LV
dépouiller le vieil homme	:LVi
dérober sa marche	:LV
dérouler le tapis rouge	:LV
déshabiller du regard	:LV
déshabiller paul pour habiller jean	:LV
déshabiller pierre pour habiller paul	:LV
désopiler la rate	:LV
déterrer la hache de guerre	:LV
dévider le jar	:LVi
dévider le jars	:LVi
dévorer des yeux	:LVt
dévorer ses larmes	:LV
dîner par cœur	:LV
effeuiller la marguerite	:LV
emboîter le pas	:LV
emboîter le pas à	:LV
embrasser comme du bon pain	:LV
embrasser la fille du canonnier	:LV
emmener faire un tour	:LV
emmener popaul au cirque	:LV
employer le vert et le sec	:LVi
employer toutes les herbes de la saint-jean	:LV
emporter de haute lutte	:LVt
emporter la balance	:LV
emporter la grenouille	:LVi
emporter la paille	:LV
emporter la pièce	:LV
emporter le chat	:LV
emporter le morceau	:LV
emporter à la pointe de l’épée	:LVt
emprunter un pain sur la fournée	:LV
en appeler à la postérité	:LV
en arracher	:LVi
en avoir	:LVi
en avoir assez	:LV
en avoir bien vu d’autres	:LV
en avoir deux	:LV
en avoir gros sur la patate	:LV
en avoir gros sur le coeur	:LV
en avoir gros sur le cœur	:LV
en avoir jusqu’aux bretelles	:LV
en avoir le cœur net	:LV
en avoir l’eau à la bouche	:LV
en avoir marre	:LV
en avoir par-dessus la tête	:LV
en avoir plein le casque	:LV
en avoir plein le cul	:LV
en avoir plein le dos	:LV
en avoir plein les bottes	:LV
en avoir plein les bras	:LV
en avoir plein les jambes	:LV
en avoir pour son argent	:LV
en avoir ras la casquette	:LV
en avoir ras le bol	:LV
en avoir ras les burnes	:LV
en avoir sa claque	:LV
en avoir son coufle	:LV
en avoir son truck	:LV
en avoir sous le capot	:LV
en avoir sous les bigoudis	:LV
en avoir vu d’autres	:LV
en baver	:LV
en baver des ronds de chapeau	:LV
en baver des ronds de citron	:LV
en boucher un coin	:LV
en chier	:LV
en connaître un bout	:LV
en connaître un rayon	:LV
en croquer	:LV
en demeurer là	:LV
en dire des vertes et des pas mûres	:LV
en dire long	:LV
en donner sa tête à couper	:LVi
en faire autant	:LV
en faire baver	:LV
en faire des caisses	:LV
en faire des tonnes	:LVi
en faire six caisses	:LV
en faire tout un plat	:LV
en faire toute une histoire	:LV
en faire un fromage	:LV
en faire un pataquès	:LV
en faire un plat	:LV
en faire une maladie	:LV
en faire une montagne	:LV
en faire voir	:LV
en faire voir	:LVi
en faire voir de toutes les couleurs	:LV
en faire voir de toutes les couleurs	:LV
en faire voir de vertes et de pas mûres	:LV
en faire voir des vertes et des pas mûres	:LV
en finir	:LV
en garder sous le coude	:LV
en imposer	:LVi
en jeter	:LVi
en mentir	:LV
en mettre plein la vue	:LV
en mettre sa main à couper	:LV
en mettre sa tête à couper	:LV
en oublier le boire et le manger	:LVi
en passer par	:LV
en passer une petite vite	:LV
en perdre son latin	:LV
en prendre de la graine	:LV
en prendre et en laisser	:LV
en prendre plein la figure	:LV
en prendre plein la gueule	:LV
en prendre plein les gencives	:LV
en prendre pour	:LV
en prendre pour son grade	:LV
en prendre son parti	:LV
en prendre un coup	:LV
en prendre un pour taper sur l’autre	:LV
en raconter	:LVt
en rajouter une couche	:LV
en rester comme deux ronds de flan	:LV
en rester là	:LV
en revenir	:LVi
en répondre sur sa tête	:LVn
en savoir long	:LV
en savoir un rayon	:LV
en tenir une bonne	:LV
en tenir une couche	:LVt
en toucher	:LV
en valoir la peine	:LV
en venir au fait	:LV
en venir aux armes	:LV
en venir aux mains	:LVi
en venir aux prises	:LV
en venir à	:LV
en venir à la preuve	:LV
en voir de toutes les couleurs	:LV
en voir des vertes et des pas mûres	:LV
en vouloir	:LVi
en écraser	:LVi
en être	:LV
en être encore à la croix de par dieu	:LV
en être pour sa peine	:LV
en être pour ses frais	:LVn
encore faut-il	:LV
enculer les mouches	:LV
enduire d’horreur	:LV
enfermer dehors	:LV
enfermer le loup dans la bergerie	:LV
enfiler des perles	:LV
enfiler la venelle	:LV
enfoncer des portes ouvertes	:LV
enfoncer le clou	:LV
enfoncer le couteau dans la plaie	:LV
enfoncer son chapeau	:LVi
enfoncer une porte ouverte	:LV
engager le fer	:LV
engager le pronostic vital	:LV
engueuler comme du poisson pourri	:LV
enlever la paille	:LV
enlever le morceau	:LV
entendre bien son fait	:LV
entendre les mouches voler	:LV
entendre parler	:LVt
entendre raison	:LV
entendre sourd	:LV
enterrer la hache de guerre	:LV
enterrer sa vie de garçon	:LV
entrer dans la danse	:LV
entrer dans la légende	:LVi
entrer dans la ronde	:LV
entrer dans la tête	:LVn
entrer dans le jeu	:LV
entrer dans le moule	:LV
entrer dans le système	:LV
entrer dans le vif du sujet	:LV
entrer dans une colère noire	:LVi
entrer de plain-pied	:LV
entrer en action	:LV
entrer en jeu	:LV
entrer en lice	:LV
entrer en ligne de compte	:LV
entrer en matière	:LV
entrer en piste	:LV
entrer en relation	:LV
entrer en scène	:LVi
entrer en vigueur	:LV
entrer par la bonne porte	:LV
entrer par la grande porte	:LV
entrer par la petite porte	:LV
entrer par une oreille et sortir par l’autre	:LV
envoyer ad patres	:LV
envoyer au bain	:LV
envoyer au diable	:LV
envoyer aux durs	:LVt
envoyer aux nouvelles	:LVt
envoyer aux pelotes	:LV
envoyer balader	:LVt
envoyer benner	:LV
envoyer bouler	:LVt
envoyer chez le bonhomme	:LVt
envoyer chier	:LV
envoyer des fleurs	:LV
envoyer des pics	:LV
envoyer des piques	:LV
envoyer des scuds	:LVi
envoyer dinguer	:LV
envoyer du bois	:LV
envoyer du pâté	:LV
envoyer la ganzou	:LV
envoyer la purée	:LV
envoyer la sauce	:LV
envoyer par le fond	:LV
envoyer paître	:LV
envoyer promener	:LVt
envoyer sur les roses	:LVt
envoyer valdinguer	:LV
envoyer valser	:LV
envoyer à dache	:LV
envoyer à la balançoire	:LV
envoyer à tous les diables	:LV
essayer de	:LVt
essayer à	:LV
essuyer les plâtres	:LVn
ester en jugement	:LV
excusez du peu	:LV
exploser le terrier	:LV
faire abstraction	:LV
faire acte de candidature	:LVi
faire acte de clémence	:LVi
faire acte de présence	:LVi
faire acte d’autorité	:LVi
faire aller	:LVt
faire alliance	:LVi
faire allusion	:LV
faire amende honorable	:LVi
faire antichambre	:LV
faire appel	:LV
faire argent de tout	:LV
faire arme de tout	:LV
faire assaut	:LV
faire assavoir	:LVt
faire attention	:LV
faire autorité	:LVi
faire avancer le schmilblick	:LV
faire avec	:LV
faire avorter une couvée de singes	:LV
faire banco	:LVi
faire bande à part	:LV
faire banqueroute	:LVi
faire beau	:LV
faire bien de	:LVi
faire binet	:LVi
faire bisquer	:LVi
faire bleu	:LV
faire boire	:LV
faire boire un cuir	:LV
faire boire une étoffe	:LV
faire bombance	:LV
faire bon accueil	:LVi
faire bon marché	:LVt
faire bon ménage	:LVi
faire bon ménage avec	:LV
faire bon visage	:LV
faire bonne chère	:LVi
faire bonne contenance	:LVi
faire bonne figure	:LV
faire bonne garde	:LVi
faire bonne impression	:LV
faire bonne mesure	:LV
faire bonne mine	:LV
faire bouillir la marmite	:LV
faire boule de neige	:LV
faire bourse commune	:LVi
faire boutique mon cul	:LV
faire braire	:LV
faire brèche	:LV
faire buisson creux	:LV
faire caca	:LV
faire cadeau	:LVi
faire caguer	:LV
faire carousse	:LV
faire carrière	:LVi
faire cas	:LV
faire cause commune	:LVi
faire cavalier seul	:LV
faire ceinture	:LVi
faire cent hontes	:LV
faire chabrot	:LV
faire chambre à part	:LV
faire chanter	:LV
faire charlemagne	:LV
faire chaud au cœur	:LVi
faire chaudière	:LV
faire chier	:LV
faire chier la bite	:LVn
faire chorus	:LVi
faire chou blanc	:LV
faire claquer son fouet	:LV
faire cocu	:LVt
faire codille	:LV
faire comme chez soi	:LVi
faire comme les copains	:LV
faire comme si	:LVi
faire confiance	:LV
faire connaissance	:LV
faire connaître qui on est	:LVi
faire contraste	:LV
faire contre mauvaise fortune bon coeur	:LV
faire contre mauvaise fortune bon cœur	:LV
faire contre mauvaise fortune, bon cœur	:LVi
faire corps	:LV
faire couler beaucoup d’encre	:LV
faire couler l’encre	:LV
faire coup double	:LVi
faire crac-crac	:LVi
faire crapahuter le flemmard	:LV
faire cru	:LVm
faire crédit	:LVi
faire cul sec	:LV
faire curée	:LV
faire côte	:LVi
faire dans sa couche	:LV
faire dans sa culotte	:LV
faire dans son froc	:LV
faire dans son pantalon	:LV
faire danser l’anse du panier	:LV
faire date	:LV
faire de la cuisine	:LVi
faire de la peine	:LVi
faire de la prose sans le savoir	:LV
faire de la terre le fossé	:LV
faire de l’autostop	:LV
faire de l’eau	:LV
faire de l’esbroufe	:LVi
faire de l’esprit	:LVi
faire de l’oeil	:LV
faire de l’ombre	:LV
faire de l’or en barre	:LV
faire de l’œil	:LV
faire de nécessité vertu	:LV
faire de plates excuses	:LV
faire de son mieux	:LVi
faire de vieux os	:LV
faire demi-tour	:LVi
faire des armes	:LV
faire des avances	:LVi
faire des balles	:LV
faire des charres	:LVn
faire des commissions	:LVi
faire des courses	:LVi
faire des emplettes	:LV
faire des façons	:LV
faire des fleurs	:LV
faire des folies	:LV
faire des frais	:LV
faire des galipettes	:LV
faire des gammes	:LV
faire des gorges chaudes	:LV
faire des histoires	:LV
faire des manières	:LVi
faire des messes basses	:LV
faire des petits	:LV
faire des pieds et des mains	:LV
faire des remontrances	:LV
faire des ronds dans l’eau	:LV
faire des ronds de jambe	:LV
faire des salades	:LV
faire des saletés	:LV
faire des siennes	:LV
faire des vacances	:LV
faire des vagues	:LV
faire des yeux de merlan frit	:LV
faire des âties	:LV
faire des émules	:LV
faire des étincelles	:LV
faire deux	:LV
faire devenir chèvre	:LV
faire difficulté	:LVi
faire diligence	:LVi
faire disparaitre	:LV
faire diversion	:LVi
faire divorce	:LV
faire dodo	:LV
faire don	:LVi
faire double emploi	:LV
faire dresser les cheveux	:LV
faire dresser les cheveux sur la tête	:LV
faire dresser les oreilles	:LV
faire dresser l’oreille	:LVi
faire droit	:LV
faire du bien	:LV
faire du boudin	:LV
faire du chiffre	:LV
faire du coude	:LVi
faire du coude à coude	:LVi
faire du covoiturage	:LVi
faire du foin	:LV
faire du genou	:LVi
faire du genre	:LV
faire du gringue	:LVn
faire du gros d’or	:LV
faire du lèche-vitrine	:LVi
faire du mal	:LV
faire du mur	:LV
faire du ménage	:LV
faire du neuf avec du vieux	:LV
faire du pied	:LV
faire du plat	:LV
faire du poney	:LV
faire du pouce	:LV
faire du rentre-dedans	:LV
faire du reuz	:LV
faire du sale boulot	:LV
faire du shopping	:LVi
faire du stop	:LV
faire du sur place	:LV
faire du tort	:LV
faire du vent	:LV
faire du zèle	:LV
faire dur	:LVm
faire durer le plaisir	:LV
faire débat	:LV
faire défaut	:LVi
faire d’une chose comme des choux de son jardin	:LV
faire d’une mouche un éléphant	:LV
faire d’une pierre deux coups	:LV
faire eau	:LV
faire effet	:LVi
faire en sorte	:LV
faire en sorte que	:LV
faire entendre raison	:LV
faire entrer en ligne de compte	:LV
faire envie	:LV
faire erreur	:LV
faire escale	:LVi
faire exprès	:LV
faire face	:LV
faire faillite	:LVi
faire fanny	:LVi
faire farine à son moulin	:LV
faire fausse queue	:LV
faire fausse route	:LV
faire faux bond	:LVi
faire faux-bond	:LVi
faire feu	:LVi
faire feu de tout bois	:LV
faire feu des deux fuseaux	:LV
faire feu des quatre fers	:LV
faire feu des quatre pattes	:LV
faire feu des quatre pieds	:LV
faire feu vif	:LV
faire fi de	:LV
faire figure de proue	:LV
faire fissa	:LVi
faire flanelle	:LV
faire florès	:LV
faire flèche de tout bois	:LV
faire foi	:LV
faire fomec	:LV
faire fonction	:LV
faire fond	:LV
faire force de rames	:LVi
faire force de voiles	:LVi
faire fortune	:LV
faire fricot	:LV
faire froid dans le dos	:LV
faire front	:LV
faire fureur	:LV
faire fête	:LV
faire gaffe	:LV
faire genre	:LV
faire grand bruit	:LV
faire grand cas	:LVi
faire gribou	:LV
faire grief	:LVi
faire grise mine	:LV
faire grâce	:LVn
faire grève	:LVi
faire halte	:LV
faire hommage à la table	:LV
faire honneur	:LVi
faire honneur à la table	:LV
faire honte	:LVn
faire impression	:LVn
faire irruption	:LV
faire jouer	:LVt
faire joujou	:LV
faire jour	:LVim
faire justice	:LVi
faire justice soi-même	:LV
faire la baboune	:LV
faire la barbe	:LVi
faire la bombe	:LV
faire la bouche en cœur	:LV
faire la bringue	:LV
faire la bête	:LV
faire la cane	:LVi
faire la charité	:LV
faire la chasse	:LVi
faire la chaîne	:LVi
faire la chevelure	:LV
faire la connaissance	:LV
faire la coquette	:LV
faire la cour	:LVi
faire la course	:LVi
faire la couverture	:LV
faire la cuisine	:LVi
faire la différence	:LV
faire la figue à	:LV
faire la file	:LV
faire la fine bouche	:LV
faire la foire	:LV
faire la fête	:LV
faire la grasse matinée	:LV
faire la grimace	:LV
faire la grâce de	:LV
faire la gueule	:LV
faire la jaille	:LV
faire la java	:LV
faire la lecture	:LVt
faire la lessive	:LV
faire la lippe	:LV
faire la loi	:LV
faire la lumière sur	:LVi
faire la main	:LV
faire la malle	:LV
faire la manche	:LV
faire la minette	:LV
faire la moisson	:LVt
faire la monnaie	:LV
faire la morale	:LV
faire la moue	:LV
faire la navette	:LV
faire la nique	:LVn
faire la noce	:LV
faire la nouba	:LV
faire la paire	:LV
faire la paix	:LV
faire la part belle à	:LV
faire la part des choses	:LV
faire la part du feu	:LVi
faire la peau	:LV
faire la peau de	:LV
faire la perruque	:LVi
faire la pige	:LVt
faire la pige à	:LV
faire la pluie et le beau temps	:LV
faire la pote	:LV
faire la poudrette	:LV
faire la pute	:LV
faire la pâque	:LV
faire la queue	:LV
faire la quête	:LV
faire la roue	:LV
faire la rue	:LV
faire la rue michel	:LVi
faire la rue thubaneau	:LV
faire la soudure	:LV
faire la sourde oreille	:LV
faire la table	:LV
faire la tournée des bistrots	:LV
faire la tournée des grands ducs	:LV
faire la tronche	:LV
faire la tête	:LV
faire la tête au carré	:LV
faire la une	:LV
faire la vaisselle	:LVi
faire la valise	:LV
faire la vie	:LVi
faire la vie dure	:LV
faire le barbot	:LVi
faire le beau	:LVi
faire le bon apôtre	:LV
faire le bourdon	:LV
faire le carême	:LV
faire le chat-brun	:LV
faire le clown	:LV
faire le con	:LV
faire le coup de fusil	:LA|:LV
faire le coup de poing	:LV
faire le cul de poule	:LV
faire le deuil	:LVi
faire le difficile	:LVi
faire le dos rond	:LV
faire le fou	:LV
faire le gilles	:LV
faire le gros dos	:LV
faire le jacques	:LVi
faire le jeu de	:LV
faire le joli cœur	:LV
faire le lien	:LV
faire le lit	:LV
faire le loup plus grand qu’il n’est	:LV
faire le lézard	:LV
faire le malin	:LVi:m:s
faire le mariole	:LVi:m:s
faire le marmiton	:LV
faire le mia	:LVi
faire le monsieur	:LVi
faire le mort	:LV
faire le mur	:LV
faire le ménage	:LV
faire le nord	:LV
faire le pas	:LV
faire le pied de grue	:LV
faire le pitre	:LV
faire le plein	:LVt
faire le pli	:LV
faire le plongeon	:LVi
faire le poids	:LV
faire le poil	:LVt
faire le point	:LV
faire le poireau	:LV
faire le pont	:LV
faire le pont-levis	:LV
faire le premier pas	:LVi
faire le rat mort	:LV
faire le sale boulot	:LV
faire le saut	:LVi
faire le tapin	:LV
faire le tigre	:LV
faire le tour	:LVn
faire le tour du cadran	:LV
faire le tour du propriétaire	:LV
faire le trottoir	:LV
faire le trou	:LV
faire le zouave	:LV
faire le zèbre	:LV
faire les 400 coups	:LV
faire les boutiques	:LVi
faire les cent pas	:LV
faire les choses à moitié	:LVi
faire les cornes à	:LV
faire les courses	:LVi
faire les façons	:LV
faire les foins	:LV
faire les frais	:LVi
faire les frais de	:LV
faire les gros yeux	:LV
faire les magasins	:LVi
faire les malins	:LVi:m:p
faire les pieds	:LV
faire les plats nets	:LV
faire les plomées	:LV:f
faire les poches	:LV
faire les poubelles	:LVi
faire les premiers pas	:LVi
faire les quatre cents coups	:LV
faire les soldes	:LV
faire les vendanges	:LV
faire les yeux doux	:LVi
faire les yeux ronds	:LV
faire levier	:LV
faire lieu de	:LV
faire loi	:LV
faire long feu	:LV
faire lourd	:LVm
faire l’affaire	:LV
faire l’amour	:LV
faire l’andouille	:LVi
faire l’appel	:LV
faire l’appoint	:LV
faire l’article	:LV
faire l’aumône	:LV
faire l’autruche	:LV
faire l’avion	:LV
faire l’effet d’une bombe	:LV
faire l’enfant	:LV
faire l’expérience de	:LV
faire l’extérieur	:LV
faire l’hélicoptère	:LV
faire l’idiot	:LV
faire l’imbécile	:LV
faire l’impossible	:LV
faire l’impression	:LVn
faire l’intérieur	:LV
faire l’objet	:LV
faire l’oeuf	:LV
faire l’âne pour avoir du son	:LV
faire l’école buissonnière	:LV
faire l’œuf	:LV
faire machine arrière	:LVi
faire main basse	:LV
faire main basse sur	:LV
faire maison nette	:LV
faire mal	:LV
faire mal au cœur	:LV
faire mal aux zygomatiques	:LV
faire marche arrière	:LV
faire marcher	:LVt
faire marron	:LVt
faire mauvais accueil	:LVi
faire mauvais genre	:LV
faire mention de	:LVt
faire mentir	:LV
faire merveille	:LV
faire mieux de	:LV
faire mille hontes	:LV
faire mine	:LV
faire minette	:LV
faire miroiter	:LVt
faire moit moit	:LV
faire monter la mayonnaise	:LV
faire montre de	:LV
faire mouche	:LV
faire mouvement	:LV
faire mumuse	:LV
faire naufrage	:LV
faire noir	:LV
faire nombre	:LV
faire nuit	:LVim
faire n’golo n’golo	:LV
faire obstruction	:LV
faire office	:LV
faire office de	:LVi
faire opposition	:LV
faire pan pan cucul	:LV
faire panache	:LV
faire panpan cucul	:LV
faire panpan-cucul	:LV
faire parler	:LVt
faire parler la poudre	:LVi
faire part	:LVn
faire partie	:LVi
faire partie des meubles	:LV
faire passer le goût du pain	:LV
faire passer l’envie de quelque chose	:LV
faire passer par le trou d’une aiguille	:LV
faire passer un chameau par le chas d’une aiguille	:LV
faire patapouf	:LV
faire patte de velours	:LVi
faire peau neuve	:LV
faire peine	:LV
faire peine à voir	:LV
faire pencher la balance	:LVi
faire perdre le goût du pain	:LV
faire petit salé	:LV
faire petite chère	:LVi
faire peu de cas	:LV
faire peur	:LVn
faire pied neuf	:LV
faire pipi	:LV
faire pitié	:LV
faire pièce	:LV
faire pièce à	:LV
faire place	:LV
faire place nette	:LV
faire place à	:LV
faire plaisir	:LV
faire pleurer dans les chaumières	:LV
faire pleurer le colosse	:LV
faire pleurer margot	:LV
faire pleurer mirza	:LV
faire pleuvoir des coups	:LV
faire popo	:LV
faire porter le chapeau	:LV
faire prendre le change	:LV
faire pression	:LV
faire preuve	:LVi
faire prime	:LV
faire profession	:LVi
faire profil bas	:LV
faire pschitt	:LV
faire pâques avant les rameaux	:LV
faire pénitence	:LV
faire péter	:LV
faire péter les watts	:LV
faire que fou	:LVi
faire que sage	:LVi
faire question	:LV
faire rage	:LVi
faire raison	:LVi
faire rasibus	:LV
faire recette	:LV
faire reconnaitre un officier	:LV
faire reconnaître	:LV
faire relâche	:LV
faire rentrer les paroles dans la gorge	:LV
faire revenir	:LVt
faire ripaille	:LV
faire risette	:LV
faire route	:LVi
faire sa b.a.	:LV
faire sa loi	:LV
faire sa main	:LV
faire sa pelote	:LV
faire sa pute	:LV
faire sa tête	:LVi
faire sa valise	:LVi
faire saigner la pastèque	:LVt
faire saillie	:LV
faire salle comble	:LV
faire sauter	:LV
faire sauter la banque	:LV
faire sauter la grenouille	:LVi
faire sauter le bouchon	:LV
faire savoir	:LVt
faire sec	:LV
faire semblant	:LV
faire sens	:LVi
faire sensation	:LVi
faire sentinelle	:LVi
faire ses adieux	:LVn
faire ses besoins	:LV
faire ses besoins	:LVi
faire ses besoins naturels	:LV
faire ses courses	:LVi
faire ses dents	:LV
faire ses humanités	:LV
faire ses lacets	:LV
faire ses premières armes	:LV
faire ses preuves	:LV
faire ses provisions	:LVi
faire ses pâques	:LV
faire ses valises	:LV
faire sien	:LVi
faire signe	:LVn
faire silence	:LV
faire sisitte	:LVi
faire sissite	:LV
faire son affaire	:LV
faire son affaire à	:LV
faire son apparition	:LVi
faire son beurre	:LV
faire son chemin	:LV
faire son coming-out	:LV
faire son compte	:LV
faire son deuil	:LVi
faire son droit	:LV
faire son mea culpa	:LVi
faire son mea-culpa	:LVi
faire son paquet	:LV
faire son registre	:LV
faire son signe de croix	:LV
faire son temps	:LV
faire son trou	:LV
faire son âge	:LV
faire sonner la grosse cloche	:LV
faire sprinter l’unijambiste	:LV
faire style	:LV
faire suer	:LVt
faire suer le burnous	:LV
faire suer le chêne sur le grand trimard	:LV
faire suer le chêne sur le trimard	:LV
faire suisse	:LV
faire suivre	:LV
faire surface	:LVi
faire table	:LV
faire table rase	:LV
faire tache	:LV
faire tache d’encre	:LV
faire tache d’huile	:LV
faire tampine	:LVi
faire tant que	:LV
faire tapis	:LV
faire tapisserie	:LV
faire tilt	:LV
faire tintin	:LV
faire tirer l’épée	:LVi
faire tomber des têtes	:LV
faire tomber le masque	:LV
faire tomber les armes des mains	:LV
faire tourner	:LVt
faire tourner bourrique	:LV
faire tourner chèvre	:LV
faire tourner en bourrique	:LV
faire tourner la tête de	:LV
faire tourner le monde	:LV
faire tourner une machine	:LVi
faire tout un fromage	:LV
faire trempette	:LV
faire trop de grâce	:LV
faire tête	:LVi
faire tête à l’orage	:LVi
faire un bail	:LV
faire un bee	:LV
faire un bi	:LV
faire un bide	:LV
faire un blocage	:LV
faire un boutte	:LV
faire un break	:LV
faire un caca nerveux	:LV
faire un carton	:LV
faire un chopin	:LV
faire un couac	:LV
faire un crime	:LV
faire un créneau	:LV
faire un dessin	:LV
faire un enfant dans le dos	:LV
faire un faux pas	:LV
faire un finger	:LV
faire un flop	:LV
faire un four	:LV
faire un grand pas	:LV
faire un malheur	:LV
faire un marché	:LV
faire un mauvais coup	:LV
faire un nœud à son mouchoir	:LV
faire un ourlet	:LV
faire un pas en avant	:LV
faire un petit dans le dos	:LV
faire un petit velours	:LVt
faire un pied de nez	:LV
faire un pont d’or	:LV
faire un prix	:LV
faire un rictus	:LV
faire un sale boulot	:LV
faire un saut	:LV
faire un signe de tête	:LV
faire un sort	:LV
faire un sort à	:LV
faire un tabac	:LV
faire un tonneau	:LV
faire un tour	:LV
faire un tour de cochon	:LV
faire un tour de table	:LV
faire un tour d’horizon	:LV
faire un trou à la lune	:LV
faire un velours	:LV
faire un vélo de	:LV
faire un à-fond	:LVi
faire une belle jambe	:LV
faire une chose tant de bond que de volée	:LV
faire une corne à un livre	:LV
faire une croix	:LV
faire une croix dessus	:LV
faire une croix sur	:LV
faire une de ces têtes	:LV
faire une douce violence à quelqu’un	:LV
faire une embardée	:LV
faire une fin	:LVi
faire une fixation	:LV
faire une fleur	:LV
faire une grâce	:LV
faire une lessive	:LVi
faire une machine	:LVi
faire une main	:LV
faire une montagne	:LVt
faire une partie de jambes en l’air	:LV
faire une passe	:LV
faire une pause	:LV
faire une paye	:LV
faire une pipée	:LV
faire une pointe	:LV
faire une queue de poisson	:LVt
faire une quête	:LV
faire une salade	:LV
faire une scène	:LV
faire une tartine	:LV
faire usage	:LV
faire valoir	:LVt
faire versaine	:LVi
faire vibrer	:LVt
faire vie commune	:LVi
faire vinaigre	:LV
faire violence	:LVn
faire vivre	:LVt
faire voile	:LVi
faire voir	:LV
faire voir du pays	:LV
faire zizi-panpan	:LV
faire zizir	:LV
faire à dieu barbe de feurre	:LV
faire à manger	:LV
faire échec	:LV
faire école	:LV
faire écran	:LV
faire élection de domicile	:LV
faire époque	:LV
faire étalage	:LVi
faire étalage de	:LV
faire étape	:LV
faire état	:LVi
faire évanouir	:LVt
faire œuvre	:LV
fausser compagnie	:LV
faut que les bottines suivent les babines	:LV
faut voir	:LV
fendre la tête	:LVn
fendre le coeur	:LV
fendre le cœur	:LV
fendre l’armure	:LV
fendre l’oreille	:LVn
fendre l’âme	:LV
fermer boutique	:LV
fermer la champlure	:LV
fermer la marche	:LV
fermer la parenthèse	:LV
fermer la porte	:LVn
fermer la porte au nez	:LV
fermer le ban	:LV
fermer les paupières	:LVi
fermer les portes	:LV
fermer les portes de janus	:LV
fermer les yeux	:LV
fermer l’oreille	:LVi
fermer sa gueule	:LV
fermer son clapet	:LV
fermer son claque merde	:LV
fermer son claque-merde	:LV
fermer à clef	:LVt
fermer à clé	:LVt
ferrer à glace	:LVt
ficher la paix	:LV
ficher le camp	:LV
ficher s	:LV
ficher à la porte	:LV
filer de l’huile	:LVi
filer doux	:LVi
filer en étoile	:LV
filer entre les doigts	:LV
filer le duce	:LVn
filer le train	:LV
filer un mauvais coton	:LV
filer à l’anglaise	:LV
finir dans le décors	:LV
finir d’entrer	:LV
finir en queue de poisson	:LV
finir ses jours	:LV
flanquer une avoine	:LV
flanquer une rouste	:LV
flanquer à la porte	:LV
foncer dans le brouillard	:LV
foncer dans le tas	:LV
foncer tête baissée	:LVi
fonder un foyer	:LV
fonder une famille	:LV
fondre comme neige au soleil	:LV
fondre en eau	:LV
fondre en larmes	:LVi
fondre en pleurs	:LVi
fondre la glace	:LV
fondre sur	:LVt
fondre à vue d’œil	:LVi
force est	:LV
forcer dans ses retranchements	:LV
forcer la main	:LV
forcer le trait	:LV
fouetter le sang	:LV
fouler aux pieds	:LVt
fourrer le chien	:LV
fourrer son nez	:LV
foutre en l’air	:LVit
foutre la merde	:LV
foutre la paix	:LV
foutre la zone	:LV
foutre le bordel	:LV
foutre le camp	:LV
foutre le feu	:LV
foutre les boules	:LV
foutre les chocottes	:LVi
foutre les jetons	:LVi
foutre sur la gueule	:LV
franchir la ligne jaune	:LV
franchir le pas	:LVi
franchir le rubicon	:LV
franchir le rubicond	:LV
franchir un cap	:LV
frapper de nullité	:LV
frapper les esprits	:LV
frapper les trois coups	:LV
frapper un ennemi à terre	:LV
frapper un grand coup	:LV
frapper un nœud	:LV
frapper à faux	:LV
frapper à mort	:LVt
frapper à toutes les portes	:LV
frayer la voie	:LV
freiner des quatre fers	:LV
friser le radin	:LVn
froncer les sourcils	:LV
frotter les oreilles	:LVn
fuck gi	:LV
fucker le chien	:LV
fuir comme la peste	:LV
fuir de la cafetière	:LV
fumer comme des cheminées	:LV:p
fumer comme des pompiers	:LV|:LV:p
fumer comme des sapeurs	:LV:p
fumer comme un pompier	:LV:s
fumer comme un sapeur	:LV:s
fumer comme une cheminée	:LV:s
fumer la moquette	:LV
fumer le calumet de la paix	:LV
fusiller du regard	:LV
fêter pâques avant les rameaux	:LV
gagner au haut	:LVi
gagner au pied	:LVi
gagner bien	:LVt
gagner chemin	:LVi
gagner de vitesse	:LVt
gagner des mille et des cents	:LV
gagner du chemin	:LVi
gagner du pays	:LVi
gagner du temps	:LV
gagner du terrain	:LVi
gagner la porte	:LVi
gagner le dessus	:LVi
gagner le dessus du vent	:LVi
gagner le gros lot	:LVi
gagner le haut	:LVi
gagner le large	:LVi
gagner le taillis	:LVi
gagner le vent	:LVi
gagner les champs	:LVi
gagner l’heure	:LVi
gagner pays	:LVi
gagner sa croûte	:LV
gagner sa vie	:LV
gagner son bifteck	:LV
gagner son pain	:LV
gagner son pain à la sueur de son front	:LVi
gagner son steak	:LV:m
gagner sur	:LVt
gagner sur soi	:LVi
gagner sur tapis vert	:LV
gagner un ticket	:LV
gagner une partie gratuite	:LV
gagner à la main	:LVit
gagner à être connu	:LV
galoper sur le bon pied	:LV
galoper sur le mauvais pied	:LV
garder de	:LVt
garder la bique	:LV
garder la chambre	:LVi
garder la ligne	:LV
garder la main	:LV
garder la maison	:LV
garder la tête froide	:LV
garder le lit	:LVi
garder le silence	:LV
garder les dindons	:LV
garder l’église au milieu du village	:LV
garder l’œil	:LV
garder son sérieux	:LVi
garder un chien de sa chienne	:LV
garder une poire pour la soif	:LV
geler comme un creton	:LV
geler à pierre fendre	:LV
glacer le sang	:LV
glacer les sangs	:LVn
glisser dans la main	:LVt
glisser des mains	:LVi
glisser entre les mains	:LVi
glisser une quenelle	:LV
gober des mouches	:LV
gosser des poils de grenouille	:LV
gouverner à un cap	:LV
graisser la patte	:LV
graisser la patte (à qqn)	:LV
gratter du papier	:LV
graver dans le marbre	:LVt
griller la politesse	:LV
griller les neurones	:LVnp
grimper au plafond	:LV
grimper au rideau	:LV
grimper aux rideaux	:LV
grimper dans les tours	:LVi
grossir le trait	:LV
grossir les rangs	:LV
grêler sur le persil	:LV
gueuler comme un veau	:LV
gâter le métier	:LV
gâter les affaires	:LV
gêner aux entournures	:LVi
gêner dans les entournures	:LVi
habiller (s’) de neuf	:LV
habiller chez francœur le poivre et la cannelle	:LV
habiller chez francœur le sucre et la cannelle	:LV
habiller de toutes pièces	:LV
habiller pour l’hiver	:LV
habiller quelqu’un	:LV
habiter au cul-du-loup	:LV
habiter sur les brouillards du rhône	:LV
hacher menu comme chair à pâté	:LV
hasarder le paquet	:LV
hasarder sa tête	:LVt
hausser le coude	:LVi
hausser les épaules	:LV
haïr pour mourir	:LV
hisser les voiles	:LV
hurler avec les loups	:LV
hurler à la mort	:LV
hypothéquer sur les brouillards du rhône	:LV
imprimer en hache	:LV
inaugurer les chrysanthèmes	:LV
induire en erreur	:LV
inventer la poudre	:LV
inventer le fil à couper le beurre	:LVi
investir dans la pierre	:LV
jacasser comme une pie	:LV
jaspiner bigorne	:LVi
jeter au panier	:LV
jeter aux lions	:LV
jeter aux orties	:LV
jeter aux oubliettes	:LV
jeter de la poudre aux yeux	:LV
jeter de l’huile sur le feu	:LVi
jeter des perles aux pourceaux	:LV
jeter des perles devant les pourceaux	:LVi
jeter des pierres dans le jardin de quelqu’un	:LV
jeter du bois à flot perdu	:LV
jeter du lest	:LV
jeter en pâture	:LV
jeter la pierre	:LV
jeter la serviette	:LV
jeter la soutane aux orties	:LVi
jeter le bébé avec l’eau du bain	:LV
jeter le froc aux orties	:LVi
jeter le gant	:LV
jeter le grappin sur	:LV
jeter le manche après la cognée	:LV
jeter le masque	:LV
jeter le mouchoir	:LVi
jeter les griffes	:LV
jeter les hauts cris	:LVi
jeter les yeux	:LVn
jeter l’ancre	:LVi
jeter l’argent par les fenêtres	:LV
jeter l’éponge	:LV
jeter par les fenêtres	:LV
jeter par terre	:LV
jeter sa gourme	:LV
jeter sa langue au chien	:LV
jeter son argent par les fenêtres	:LV
jeter son bonnet par-dessus les moulins	:LV
jeter son dévolu	:LV
jeter son dévolu sur	:LV
jeter sur le dos	:LV
jeter sur le pavé	:LV
jeter un coup d’œil	:LV
jeter un froid	:LV
jeter un pont	:LV
jeter un sort	:LV
jeter un voile	:LV
jeter un œil	:LV
jeter une lumière crue	:LVi
jeter à la face	:LV
jeter à la porte	:LV
jeter à la rue	:LVt
jeter à la tête de	:LVt
joindre le geste à la parole	:LV
joindre les deux bouts	:LVi
jouer au chat et à la souris	:LV
jouer au con	:LV
jouer au docteur	:LV
jouer au fin	:LVi
jouer au gendarme et au voleur	:LV
jouer au papa et à la maman	:LV
jouer au plus fin	:LV
jouer au plus fort	:LV
jouer au souffleur	:LV
jouer au vert	:LVi
jouer avec le feu	:LVi
jouer cartes sur table	:LV
jouer dans la cour des grands	:LV
jouer dans le mouvement	:LVt
jouer de malheur	:LVi
jouer des biscotos	:LV
jouer des castagnettes	:LV
jouer des coudes	:LV
jouer des fesses	:LVi
jouer des mâchoires	:LV
jouer des poings	:LV
jouer des tours pendables	:LVi
jouer double jeu	:LV
jouer du manicordion	:LV
jouer du manicordion à double semelle	:LV
jouer du pipeau	:LV
jouer du serre-croupière	:LV
jouer franc jeu	:LV
jouer gros jeu	:LV
jouer jusqu’à sa dernière chemise	:LVi
jouer la carotte	:LV
jouer la carte de	:LV
jouer la comédie	:LV
jouer le béton	:LV
jouer le jeu	:LV
jouer le tout pour le tout	:LV
jouer les cassandre	:LV
jouer les durs	:LV
jouer les gros bras	:LV
jouer les étonnées	:LV
jouer les étonnés	:LV
jouer pièce	:LVi
jouer sa dernière carte	:LVi
jouer sans prendre	:LVi
jouer serré	:LV
jouer son va-tout	:LV
jouer sur les deux tableaux	:LV
jouer sur les mots	:LV
jouer sur tous les tableaux	:LV
jouer un cul	:LV
jouer un mauvais tour	:LVi
jouer un rôle	:LV
jouer un sale tour	:LV
jouer un tour	:LV
jouer un tour de cochon	:LV
jouer un tour pendable	:LVi
jouer un vilain tour	:LV
jouer une carte	:LV
jouer à cache-cache	:LVi
jouer à guichets fermés	:LV
jouer à qui perd gagne	:LVi
jouer à tout perdre	:LVi
jouer à zizi-panpan	:LV
juger de la pièce par l’échantillon	:LV
juger des coups	:LV
juger sur l’étiquette	:LV
jurer ses grands dieux	:LVi
la boucler	:LV
la chair est faible	:LV
la crever	:LVi
la faire à l’envers	:LV
la faire à l’oseille	:LVi
la fermer	:LV
la force des choses	:LV
la mettre en sourdine	:LV
la mettre en veilleuse	:LV
la ramener	:LVi
la sentir passer	:LV
la tache du péché	:LV:f
la trouver saumâtre	:LV
la vérité si je mens	:LV
laisser aller	:LV
laisser au vestiaire	:LV
laisser aux mains de	:LV
laisser bouillir	:LV
laisser carte blanche	:LV
laisser coi	:LV
laisser couler	:LV
laisser couler le vent sur les tuiles	:LV
laisser couler l’eau	:LV
laisser courir	:LV
laisser courir le vent sur les tuiles	:LV
laisser cuire dans son jus	:LVt
laisser de côté	:LV
laisser des plumes	:LV
laisser dormir	:LV
laisser en plan	:LVt
laisser en plant	:LVt
laisser en rade	:LV
laisser en sommeil	:LVi
laisser entendre	:LV
laisser entre les mains	:LV
laisser froid	:LVt
laisser la porte ouverte	:LV
laisser le champ libre	:LV
laisser mijoter quelqu’un dans son jus	:LV
laisser parler son cœur	:LV
laisser passer	:LVt
laisser passer le bout de l’oreille	:LV
laisser passer le cours	:LVi
laisser percer le bout de l’oreille	:LV
laisser pisser	:LV
laisser pisser	:LV
laisser pisser le mérinos	:LV
laisser pisser les mérinos	:LV
laisser place à	:LV
laisser planer un doute	:LV
laisser porter	:LVi
laisser pour compte	:LV
laisser sur l’âne	:LV
laisser tomber	:LV
laisser tomber quelqu’un comme une vieille chaussette	:LV
laisser voir	:LV
laisser à désirer	:LV
laissez vibrer	:LV:i
lancer des piques	:LV
lancer des éclairs	:LV
lancer le bal	:LV
lancer un pavé dans la mare	:LV
larguer les amarres	:LV
laver la tête	:LVn
laver son linge sale	:LV
laver son linge sale en famille	:LV
laver son linge sale en public	:LV
le donner au plus habile à mieux faire	:LVi
le donner en mille	:LV
le porter haut	:LVi
le prendre de haut	:LVt
les casser	:LV
les mains liées	:LV
les mettre	:LV
les nerfs en boule	:LV
les nerfs à fleur de peau	:LV
les nerfs à vif	:LV
lever la crosse en l’air	:LVi
lever la dîme	:LV
lever la garde	:LV
lever la lettre	:LV
lever la main	:LV
lever la main (sur qn)	:LV
lever la main sur quelqu’un	:LVt
lever la paille	:LVi
lever la patte	:LV
lever la sentinelle	:LV
lever la séance	:LV
lever la toile	:LV
lever la tête	:LV
lever le camp	:LV
lever le corps	:LV
lever le coude	:LVi
lever le cœur	:LV
lever le doigt	:LV
lever le lièvre	:LV
lever le masque	:LV
lever le petit doigt	:LV
lever le pied	:LV
lever le rideau	:LV
lever le siège	:LV
lever les bras	:LV
lever les bras au ciel	:LV
lever les cartes	:LV
lever les cornes	:LV
lever les fourches	:LV
lever les yeux	:LV
lever les épaules	:LV
lever l’ancre	:LV
lever l’étendard	:LV
lever sa cour	:LV
lever une exception	:LV
libérer mandela	:LVi
lire en diagonale	:LV
lire en quelqu’un comme dans un livre ouvert	:LV
lire entre les lignes	:LV
lire sur les lèvres	:LV
loger chez l’habitant	:LV
loin du compte	:LVi
louer jusqu’au vif	:LV
louper le coche	:LV
lui en donner d’une	:LVi
lui en donner d’une bonne	:LVi
lâche pas la patate	:LV
lâcher du lest	:LV
lâcher la bride	:LVi
lâcher la détente	:LVt
lâcher la grappe	:LV
lâcher la main	:LV
lâcher la proie pour l’ombre	:LV
lâcher le morceau	:LV
lâcher les baskets	:LV
lâcher les basques	:LV
lâcher l’affaire	:LV
lâcher l’aiguillette	:LV
lâcher médor	:LV
lâcher pied	:LV
lâcher prise	:LNi:m|:LVi
lâcher un ouac	:LVt
lâcher un wack	:LV
lâcher une caisse	:LVi
lâcher une perle	:LVi
lécher le cul	:LV
lécher les bottes	:LV
lécher les vitrines	:LV
léser avec un grand b	:LV
l’avoir dans le cul	:LV
l’avoir dans l’os	:LV
l’avoir manqué belle	:LVi
l’avoir mauvaise	:LVi
l’avoir échappé belle	:LV
l’entendre de cette oreille	:LV
l’habit fait l’homme	:LV
l’habit volé ne va pas au voleur	:LV
l’échapper belle	:LV
manger avec un lance-pierre	:LV
manger comme des cochons	:LV:m:p
manger comme quatre	:LV
manger comme un cochon	:LV:m:s
manger comme un loup	:LV
manger comme un moineau	:LV
manger comme un ogre	:LV:m:s
manger comme un porc	:LV
manger comme une cochonne	:LV
manger comme une mauviette	:LV
manger dans la main	:LV
manger de la marde	:LVi
manger de la vache enragée	:LV
manger des beignets après la pentecôte	:LV
manger des yeux	:LV
manger du lion	:LV
manger du lotus	:LVi
manger la feuille	:LV
manger la feuille de match	:LV
manger la grenouille	:LVi
manger la puck	:LV
manger le diable et ses cornes	:LV
manger le morceau	:LVi
manger les grillots avec le tac-tac	:LV
manger les pissenlits par la racine	:LV
manger l’oreiller	:LV
manger ses bas	:LV
manger ses croûtes	:LV
manger ses quatre sous	:LVi
manger son blé en herbe	:LVi
manger son blé en vert	:LVi
manger son chapeau	:LV
manger son pain blanc	:LV
manger son pain blanc le premier	:LV
manger son pain noir	:LV
manger son pain à la fumée du rôt	:LVi
manger sur le pouce	:LVt
manger sur les brouillards du rhône	:LV
manger un morceau	:LVi
manger un rat	:LV
manger un rat mort	:LV
manger une balle	:LV
manger une bouchée	:LV
manger une volée	:LV
manger à s’en faire péter la sous-ventrière	:LV
manger à s’en faire péter la souventrière	:LV
manger à tous les râteliers	:LV
mangeux de puck	:LV
manier bien la parole	:LVi
manière noire	:LV:f
manquer de	:LVt
manquer de respect	:LV
manquer le coche	:LV
manquer son coup	:LV
manquer une case	:LV
manquer à	:LVt
manquer à l’appel	:LV
maquiller les brèmes	:LVi
marcher dans les pas de	:LV
marcher droit	:LVi
marcher du feu de dieu	:LV
marcher en ordre de bataille	:LV
marcher sur des œufs	:LV
marcher sur la chrétienté	:LV
marcher sur la france	:LV
marcher sur la tête	:LV
marcher sur les pas	:LV
marcher sur les pas de	:LV
marcher sur les pieds	:LV
marcher sur les plates bandes	:LV
marcher sur les plates-bandes	:LVi
marcher sur les plates-bandes de quelqu’un	:LV
marcher sur les talons	:LV
marcher sur les traces	:LV
marcher à pas comptés	:LV
marcher à quatre pattes	:LV
marcher à voile et à vapeur	:LVi
marquer d’une pierre blanche	:LV
marquer d’une pierre noire	:LV
marquer le coup	:LV
marquer le pas	:LV
marquer son époque	:LV
masquer en grand	:LVi
mazouter le pingouin	:LV
menacer ruine	:LVi
mener (quelqu’un) en bateau	:LV
mener au supplice	:LV
mener de front	:LVt
mener doucement	:LVi
mener en bateau	:LVt
mener en lisière	:LVi
mener en triomphe	:LVt
mener grand bruit	:LVi
mener grand deuil	:LVi
mener grand train	:LV
mener joyeuse vie	:LVi
mener la danse	:LVi
mener le bal	:LV
mener le branle	:LVi
mener le deuil	:LVi
mener le jeu	:LVi
mener loin	:LVi
mener par le bout du nez	:LVt
mener par le nez	:LVt
mener par un chemin où il n’y aura pas de pierres	:LVt
mener quelqu’un par le bout du nez	:LVt
mener rondement	:LVi
mener rudement	:LVi
mener sa barque	:LV
mener son monde	:LV
mener sur le poing	:LVt
mener tambour battant	:LVt
mener une vie de bâton de chaise	:LV
mener une vie de bâtons de chaise	:LV
mener une vie de chien	:LV
mener une vie de cénobite	:LV
mener une vie joyeuse	:LVi
mener à bien	:LVt
mener à bonne fin	:LV
mener à la baguette	:LVt
mentir comme un arracheur de dents	:LV
mentir comme un laquais	:LV
mentir comme une arracheuse de dents	:LV
mentir par la gorge	:LVi
mentir par la gueule	:LVi
mentir par sa gorge	:LVi
mentir sa foi	:LVi
mentir à son passé	:LVi
mettre au ban	:LVt
mettre au ban de l’empire	:LVt
mettre au bleu	:LV
mettre au clair	:LV
mettre au clou	:LVt
mettre au coin	:LV
mettre au désespoir	:LV
mettre au frigo	:LV
mettre au jour	:LV
mettre au monde	:LVt
mettre au net	:LV
mettre au panier	:LV
mettre au parfum	:LV
mettre au pas	:LV
mettre au pied du mur	:LV
mettre au pilori	:LV
mettre au placard	:LV
mettre au point	:LVt
mettre au pot	:LVt
mettre au rancart	:LV
mettre au secret	:LVt
mettre au tain	:LVt
mettre au tapis	:LV
mettre au travail	:LV
mettre aux ambles	:LVt
mettre aux arrêts	:LV
mettre aux fers	:LV
mettre aux mains	:LV
mettre aux pieds de la croix	:LV
mettre aux pieds du crucifix	:LV
mettre aux prises	:LV
mettre aux voix	:LV
mettre bas	:LVt
mettre bien	:LVt
mettre chapeau bas	:LVi
mettre dans la balance	:LV
mettre dans la tête	:LV
mettre dans le mille	:LV
mettre dans le même panier	:LV
mettre dans le même sac	:LV
mettre dans l’os	:LV
mettre dans sa poche	:LVt
mettre dans son tort	:LVt
mettre de côté	:LVt
mettre de l’eau dans son vin	:LV
mettre de l’huile dans les rouages	:LV
mettre de l’huile sur le feu	:LVi
mettre dedans	:LVt
mettre des bâtons dans les roues	:LV
mettre des cornes	:LV
mettre des gants	:LV
mettre des grains de sable dans les rouages	:LV
mettre du beurre dans les épinards	:LV
mettre du cœur (à l’ouvrage)	:LV
mettre du sien	:LVi
mettre du temps	:LVi
mettre d’accord	:LV
mettre en avant	:LVt
mettre en berne	:LV
mettre en bière	:LV:f
mettre en boite	:LV
mettre en boule	:LV
mettre en bouteille	:LV
mettre en boîte	:LV
mettre en branle	:LV
mettre en cause	:LV
mettre en chantier	:LV
mettre en colère	:LV
mettre en curée	:LV
mettre en danger	:LVt
mettre en demeure	:LV
mettre en doute	:LV
mettre en examen	:LV
mettre en exergue	:LV
mettre en fait	:LV
mettre en fuite	:LV
mettre en garde	:LV
mettre en honneur	:LV
mettre en jeu	:LV
mettre en joue	:LV
mettre en ligne	:LVt
mettre en ligne de compte	:LVt
mettre en lumière	:LV
mettre en marche	:LVt
mettre en pièces	:LV
mettre en place	:LVt
mettre en pleine lumière	:LV
mettre en poche	:LV
mettre en pratique	:LVt
mettre en présence	:LVt
mettre en péril	:LVt
mettre en pétard	:LV
mettre en rapport	:LVt
mettre en roman	:LVt
mettre en route	:LVt
mettre en scène	:LV
mettre en selle	:LV
mettre en sommeil	:LV
mettre en train	:LVt
mettre en usage	:LV
mettre en valeur	:LVt
mettre en veilleuse	:LV
mettre en état	:LVt
mettre en éveil	:LV
mettre en évidence	:LVt
mettre en œuvre	:LV
mettre enceinte	:LVt
mettre entre parenthèses	:LVt
mettre fin	:LVt
mettre fin à ses jours	:LV
mettre habit bas	:LV
mettre hors de cause	:LV
mettre la bride sur le cou	:LVi
mettre la charrue avant les boeufs	:LV
mettre la charrue avant les bœufs	:LV
mettre la clef sous la porte	:LVi
mettre la clé sous la porte	:LVi
mettre la clé sous le paillasson	:LV
mettre la crosse en l’air	:LVi
mettre la dernière main	:LV
mettre la dernière main à	:LV
mettre la gomme	:LV
mettre la main	:LV
mettre la main au collet à	:LVn
mettre la main au panier	:LV
mettre la main sur la conscience	:LVi
mettre la main à	:LV
mettre la main à la plume	:LV
mettre la main à la poche	:LV
mettre la main à la pâte	:LV
mettre la main à l’œuvre	:LV
mettre la misère	:LV
mettre la ouache	:LV
mettre la paille au cul	:LV
mettre la porte contre	:LV
mettre la pression	:LV
mettre la puce à l’oreille	:LV
mettre la pâtée	:LV
mettre la pédale au fond	:LV
mettre la pédale douce	:LV
mettre la quenelle dans le shaker	:LV
mettre la table	:LV
mettre la tête à prix	:LVi
mettre la zone	:LV
mettre le bal en train	:LV
mettre le cap	:LVn
mettre le comble	:LV
mettre le couvercle sur la marmite	:LV
mettre le doigt dans l’engrenage	:LV
mettre le doigt sur	:LVt
mettre le doigt sur la plaie	:LV
mettre le feu	:LV
mettre le feu aux poudres	:LVi
mettre le grappin	:LV
mettre le grappin sur	:LV
mettre le holà	:LV
mettre le marché en main	:LV
mettre le marché à la main	:LVi
mettre le nez dans la plume	:LVi
mettre le nez dans les livres	:LVi
mettre le nez de quelqu’un dans sa merde	:LV
mettre le nez dehors	:LV
mettre le paquet	:LV
mettre le pied	:LV
mettre le pied dans la porte	:LV
mettre le pied sur la gorge	:LV
mettre le pied à l’étrier	:LV
mettre le temps	:LVi
mettre le turbo	:LV
mettre le violon à la main	:LVi
mettre les adjas	:LV
mettre les armes bas	:LV
mettre les armes à la main	:LVi
mettre les bouchées doubles	:LV
mettre les bouts	:LV
mettre les clefs sous la porte	:LVi
mettre les cuirs au refroid	:LV:m
mettre les fers au feu	:LV
mettre les gaz	:LV
mettre les mains dans le cambouis	:LV
mettre les petits plats dans les grands	:LV
mettre les pieds	:LV
mettre les pieds dans le plat	:LV
mettre les pieds quelque part	:LV
mettre les points sur les i	:LV
mettre les points sur les i et les barres aux t	:LV
mettre les points sur les i et les barres sur les t	:LV
mettre les pouces	:LV
mettre les voiles	:LV
mettre l’accent sur	:LV
mettre l’épaule à la roue	:LV
mettre l’épée à la main	:LV
mettre mal	:LVt
mettre minable	:LV
mettre pavillon bas	:LVi
mettre pied à terre	:LVi
mettre plus bas que terre	:LV
mettre sa main au feu	:LV
mettre sa tête à couper	:LV
mettre ses couilles sur la table	:LV
mettre ses tripes sur la table	:LV
mettre son compte	:LV
mettre son drapeau dans sa poche	:LV
mettre son grain de sel	:LV
mettre son pied quelque part	:LV
mettre sou sur sou	:LVi
mettre sous clé	:LV
mettre sous presse	:LV
mettre sous ses pieds	:LV
mettre sous voiles	:LV
mettre sur la glace	:LV
mettre sur la gueule	:LV
mettre sur la paille	:LVt
mettre sur la sellette	:LVt
mettre sur la table	:LV
mettre sur la touche	:LV
mettre sur la voie	:LV
mettre sur le bon pied	:LV
mettre sur le carreau	:LV
mettre sur le dos	:LV
mettre sur le marché	:LV
mettre sur le pinacle	:LV
mettre sur le tapis	:LV
mettre sur les dents	:LV
mettre sur l’âne	:LV
mettre sur pied	:LV
mettre sur soi tout ce qu’on gagne	:LVi
mettre sur un bon pied	:LV
mettre tous les œufs dans le même panier	:LV
mettre tous ses œufs dans le même panier	:LV
mettre un bémol	:LV
mettre un coup de collier	:LV
mettre un fuck	:LV
mettre un pain	:LV
mettre un point d’honneur à	:LV
mettre un point final	:LV
mettre un terme	:LVi
mettre un tigre dans son moteur	:LV
mettre une chasse	:LVn
mettre une croix sur	:LV
mettre une grosse tête	:LV
mettre une pile	:LV
mettre une sourdine	:LV
mettre à bout	:LV
mettre à couvert	:LVt
mettre à côté de la plaque	:LV
mettre à disposition	:LVt
mettre à flot	:LV
mettre à gauche	:LV
mettre à genoux	:LV
mettre à jour	:LVt
mettre à la cape	:LVt
mettre à la disposition	:LVt
mettre à la lanterne	:LV
mettre à la porte	:LV
mettre à la raison	:LVt
mettre à la rue	:LV
mettre à la voile	:LV
mettre à longueur	:LV
mettre à l’amende	:LVt
mettre à l’herbe	:LVt
mettre à l’index	:LV
mettre à l’ombre	:LV
mettre à l’écart	:LV
mettre à l’épreuve	:LVt
mettre à mal	:LVt
mettre à mort	:LVt
mettre à niveau	:LVt
mettre à nu	:LVt
mettre à pied	:LV
mettre à plat	:LV
mettre à profit	:LVt
mettre à quia	:LVt
mettre à rançon	:LVt
mettre à sac	:LV
mettre à terre	:LV
mettre à toutes les sauces	:LVt
mijoter dans son jus	:LV
mijoter une affaire	:LV
miser sur le bon cheval	:LV
miser sur le mauvais cheval	:LV
moissonner des lauriers	:LV
monter au ciel	:LV
monter au créneau	:LV
monter au filet	:LV
monter au front	:LV
monter aux barricades	:LV
monter aux nues	:LVi
monter d’un cran	:LV
monter en chaire	:LVi
monter en croupe	:LVi
monter en grade	:LV
monter en graine	:LV
monter en ligne	:LVi
monter en épi	:LV
monter en épingle	:LV
monter la garde	:LVi
monter les talons	:LVi
monter sa grand-mère au grenier	:LV
monter sec	:LV
monter serré	:LV
monter son nez	:LVi
monter sur le trône	:LVi
monter sur les planches	:LV
monter sur ses ergots	:LVi
monter sur ses grands chevaux	:LV
monter un char	:LVi
monter un turbin	:LV
monter à la genette	:LVit
monter à la tête	:LV
monter à l’assaut	:LV
monter à l’estradiote	:LVit
montrer au doigt	:LVi
montrer du doigt	:LVi
montrer la corde	:LVi
montrer la porte	:LVi
montrer le bout de l’oreille	:LVi
montrer le bout de son nez	:LV
montrer le bout de son nez	:LVi
montrer le chemin	:LVi
montrer le doigt	:LV
montrer le soleil avec un flambeau	:LV
montrer les cornes	:LV
montrer les dents	:LVi
montrer patte blanche	:LV
montrer qui c’est raoul	:LV
montrer sa lune	:LV
montrer son bec jaune	:LV
montrer son béjaune	:LV
montrer son nez	:LV
mordre la main nourricière	:LV
mordre la main qui nourrit	:LV
mordre la poussière	:LV
mordre la terre	:LV
mordre le sein de sa nourrice	:LV
mordre sur sa chique	:LV
mordre à la grappe	:LV
mordre à l’hameçon	:LV
moucher les chandelles	:LV
mouiller la chemise	:LV
mouiller sa chemise	:LV
mouiller son lit	:LVi
mouiller à siaux	:LVim
mouler un cake	:LV
mourir au lit d’honneur	:LV
mourir comme un chien	:LV
mourir dans les cheveux noirs	:LV
mourir de faim	:LVi
mourir de honte	:LV
mourir de rire	:LV
mourir debout	:LV
mourir sur la paille	:LVi
mourir à la peine	:LV
mouton noiriser	:LVt
mâcher la besogne	:LV
mâcher le travail	:LV
mélanger des choux et des carottes	:LV
mélanger les torchons et les serviettes	:LV
ménager la chèvre et le chou	:LV
ménager le terrain	:LV
ménager sa peine	:LV
nager comme un fer à repasser	:LV
nager dans le bleu	:LV
nager entre deux eaux	:LV
naviguer de conserve	:LV
naviguer en eaux troubles	:LVi
naviguer à vue	:LV
naître coiffé	:LV
naître de	:LVt
naître sous une bonne étoile	:LV
naître sous une mauvaise étoile	:LV
naître à	:LVt
ne chercher que plaie et bosse	:LV
ne connaitre ni d’ève ni d’adam	:LV
ne connaître ni des lèvres ni des dents	:LV
ne connaître ni d’ève ni d’adam	:LV
ne connaître pas sa main droite de sa main gauche	:LVi
ne connaître plus rien	:LVi
ne connaître que	:LVi
ne craindre ni dieu ni diable	:LVi
ne céder en rien	:LVn
ne demander qu’à	:LV
ne dormir que d’un oeil	:LV
ne dormir que d’un œil	:LV
ne douter de rien	:LV
ne faire aucun doute	:LV
ne faire ni chaud ni froid	:LV
ne faire ni une ni deux	:LV
ne faire que	:LVt
ne faire que de sortir de la coquille	:LV
ne faire que tordre et avaler	:LV
ne faire qu’une bouchée	:LV
ne faire rien qui vaille	:LVi
ne faire semblant de rien	:LV
ne jurer que par	:LVt
ne manquer plus que	:LV
ne mener à rien	:LVi
ne parler que par apophtegmes	:LV
ne pas aller chier loin	:LV
ne pas aller sans	:LV
ne pas arriver à la cheville	:LV
ne pas arriver à la cheville de quelqu’un	:LV
ne pas attacher son chien avec des saucisses	:LV
ne pas attendre l’autre	:LV
ne pas avoir besoin d’un cours classique pour	:LV
ne pas avoir de talent	:LV
ne pas avoir d’allure	:LV
ne pas avoir fait une panse d’a	:LV
ne pas avoir froid aux yeux	:LV
ne pas avoir gardé les cochons ensemble	:LV
ne pas avoir gardé les moutons ensemble	:LV
ne pas avoir inventé la corde à tourner le vent	:LV
ne pas avoir inventé la poudre	:LV
ne pas avoir inventé le bidon de deux litres	:LV
ne pas avoir inventé le fil à couper le beurre	:LVi
ne pas avoir inventé l’eau chaude	:LV
ne pas avoir inventé l’eau tiède	:LV
ne pas avoir la lumière à tous les étages	:LV
ne pas avoir la tête à	:LV
ne pas avoir le temps de dire ouf	:LV
ne pas avoir les deux pieds dans le même sabot	:LVi
ne pas avoir les yeux dans sa poche	:LV
ne pas avoir les yeux en face des trous	:LV
ne pas avoir sa langue dans sa poche	:LV
ne pas avoir toute sa tête	:LV
ne pas avoir un poil de sec	:LV
ne pas avoir une cenne	:LV
ne pas avoir voix au chapitre	:LV
ne pas badiner	:LV
ne pas bouger d’une oreille	:LV
ne pas bouger le petit doigt	:LV
ne pas casser des briques	:LV
ne pas casser trois pattes à un canard	:LV
ne pas connaître son bonheur	:LV
ne pas croire si bien dire	:LV
ne pas céder d’un pouce de terrain	:LV
ne pas céder pour un empire	:LV
ne pas desserrer les dents	:LV
ne pas digérer	:LV
ne pas dire non	:LV
ne pas donner signe de vie	:LVi
ne pas durer aussi longtemps que le marché de villefranche	:LVi
ne pas déparer	:LV
ne pas désenivrer	:LV
ne pas en croire ses oreilles	:LV
ne pas en croire ses yeux	:LV
ne pas en dormir	:LV
ne pas en ficher une	:LV
ne pas en foutre une rame	:LV
ne pas en mener large	:LV
ne pas en mourir	:LV
ne pas en perdre une bouchée	:LV
ne pas en perdre une miette	:LVi
ne pas en rater une	:LV
ne pas en revenir	:LVi
ne pas en toucher une	:LV
ne pas entrer dans la tête	:LV
ne pas faire dans la dentelle	:LV
ne pas faire de cadeau	:LV
ne pas faire de mal à une mouche	:LVi
ne pas faire de quartier	:LVi
ne pas faire de vieux os	:LVi
ne pas faire façon de	:LV
ne pas faire long feu	:LV
ne pas faire son âge	:LVi
ne pas faire un pli	:LV
ne pas fermer l’oeil	:LV
ne pas fermer l’œil	:LV
ne pas gérer un cachou	:LV
ne pas jouer dans la même cour	:LV
ne pas laisser de	:LV
ne pas laisser pierre sur pierre	:LV
ne pas lever le petit doigt	:LV
ne pas lâcher d’une semelle	:LVt
ne pas l’avoir volé	:LV
ne pas l’emporter au paradis	:LV
ne pas manger de ce pain-là	:LV
ne pas manquer de piquant	:LV
ne pas manquer de sel	:LV
ne pas manquer de souffle	:LV
ne pas manquer d’air	:LV
ne pas marchander	:LV
ne pas marquer l’heure	:LV
ne pas mourir idiot	:LV
ne pas mâcher ses mots	:LV
ne pas perdre le nord	:LV
ne pas perdre une miette	:LV
ne pas perdre une seconde	:LV
ne pas piper	:LV
ne pas pouvoir ne pas	:LV
ne pas quitter des yeux	:LVt
ne pas quitter d’une semelle	:LV
ne pas rester pierre sur pierre	:LV
ne pas savoir sur quel pied danser	:LV
ne pas se bousculer au portillon	:LV
ne pas se chauffer du même bois	:LV
ne pas se donner de coups de pied	:LV
ne pas se fouler	:LVi
ne pas se fouler la rate	:LV
ne pas se moucher avec des pelures d’oignon	:LV
ne pas se moucher du coude	:LV
ne pas se moucher du pied	:LV
ne pas se prendre pour de la merde	:LV
ne pas se torcher avec le cul de la chemise	:LV
ne pas se trouver sous le pas d’un cheval	:LVi
ne pas se trouver sous les sabots d’un cheval	:LV
ne pas sentir la rose	:LV
ne pas sortir de là	:LVi
ne pas sucer que des glaçons	:LV
ne pas s’en sentir le jour de ses noces	:LV
ne pas toucher la terre	:LV
ne pas tourner rond	:LV
ne pas valoir chipette	:LVi
ne pas valoir la chandelle	:LV
ne pas valoir la corde pour le pendre	:LV
ne pas valoir pipette	:LV
ne pas valoir tripette	:LV
ne pas valoir un clou	:LV
ne pas valoir un coup de cidre	:LV
ne pas valoir un pet de lapin	:LV
ne pas valoir un pet de loup	:LV
ne pas vivre	:LVi
ne pas voir passer le puck	:LV
ne pas voir plus loin que le bout de son nez	:LV
ne pas voir plus loin que son nez	:LV
ne pas vouloir la mort du pécheur	:LVi
ne pas vouloir regarder	:LV
ne pas y aller avec le dos de la cuiller	:LV
ne pas y aller avec le dos de la cuillère	:LV
ne pas y aller de main morte	:LV
ne pas y aller par quatre chemins	:LV
ne pas y avoir de quoi se vanter	:LV
ne pas y avoir photo	:LV
ne pas y avoir péril en la demeure	:LV
ne pas être aidé	:LV
ne pas être au bout de ses peines	:LV
ne pas être aux pièces	:LV
ne pas être dans le coup	:LV
ne pas être dans son assiette	:LV
ne pas être de bois	:LV
ne pas être de fer	:LV
ne pas être de la roupie de sansonnet	:LV
ne pas être donné	:LV
ne pas être du monde	:LV
ne pas être déçu du voyage	:LV
ne pas être en odeur de sainteté	:LV
ne pas être en reste	:LV
ne pas être en sucre	:LV
ne pas être fait pour les chiens	:LV
ne pas être fini	:LV
ne pas être indifférente	:LV
ne pas être la moitié d’un con	:LV
ne pas être la tasse de thé	:LV
ne pas être le pérou	:LV
ne pas être manchot	:LV
ne pas être net	:LV
ne pas être né de la dernière pluie	:LV
ne pas être piqué des hannetons	:LV
ne pas être piqué des vers	:LV
ne pas être pour	:LV
ne pas être son jour	:LV
ne pas être sortable	:LV
ne pas être sorti de l’auberge	:LV
ne pas être sorti du bois	:LV
ne pas être tombé de la dernière pluie	:LV
ne pas être une flèche	:LVi
ne pas être une lumière	:LVi
ne pas être une mince affaire	:LV
ne pas être à cinq minutes	:LV
ne pas être à la noce	:LV
ne pas être à prendre avec des pincettes	:LVi
ne penser qu’à ça	:LV
ne perdre rien pour attendre	:LVi
ne plus avoir de jambes	:LV
ne plus avoir de jus	:LV
ne plus avoir de secret	:LV
ne plus avoir une cenne	:LV
ne plus connaître	:LVt
ne plus pouvoir voir en peinture	:LV
ne plus savoir où donner de la tête	:LV
ne plus savoir où on en est	:LV
ne plus savoir où se mettre	:LV
ne plus savoir quoi inventer	:LV
ne plus savoir sur quel pied danser	:LV
ne plus se causer	:LV
ne plus se connaître	:LVi
ne plus se sentir	:LVi
ne plus se sentir pisser	:LV
ne plus toucher terre	:LV
ne pouvoir mettre un pied devant l’autre	:LV
ne pouvoir s’en prendre qu’à soi-même	:LV
ne reculer devant rien	:LVi
ne remuer ni pied ni patte	:LV
ne ressembler à rien	:LV
ne rien avoir dans la tête	:LV
ne rien avoir dans le pantalon	:LV
ne rien avoir à faire avec	:LV
ne rien avoir à perdre	:LV
ne rien branler	:LV
ne rien devoir à personne	:LVi
ne rien dire qui vaille	:LVi
ne rien faire de ses dix doigts	:LVi
ne rimer à rien	:LV
ne savoir ce qu’on veut	:LVi
ne savoir ni a ni b	:LV
ne savoir ni ce qu’on fait, ni ce qu’on dit	:LVi
ne savoir où donner de la tête	:LVi
ne savoir où se fourrer	:LVi
ne savoir où se mettre	:LVi
ne savoir pas distinguer sa main gauche de sa main droite	:LVi
ne savoir que faire	:LVn
ne savoir rien de rien	:LV
ne souffler mot	:LV
ne s’être pas regardé	:LV
ne tenir ni à clou ni à cheville	:LVi
ne tenir qu’à un cheveu	:LV
ne toucher qu’avec les yeux	:LV
ne trop savoir	:LV
ne valoir pas le pain qu’on mange	:LV
ne valoir plus rien	:LVi
ne valoir rien	:LVi
ne vivre que de carottes	:LV
ne vivre que pour soi	:LVi
ne voilà-t-il pas	:LV
ne voir personne	:LV
neiger comme le père du loup	:LV
neiger des quatre vents	:LV
neiger en peau de lièvre	:LV
neiger en torchons	:LV
neiger à plein temps	:LVim
nettoyer les écuries d’augias	:LV
nier le contraire	:LV
nifer de l’acré	:LV
niquer sa mère	:LV
niquer sa race	:LV
noircir du papier	:LVi
noircir le tableau	:LV
nouer l’aiguillette	:LV
nourrir les pissenlits par la racine	:LV
nourrir son homme	:LVi
nourrir un serpent dans son sein	:LVi
noyer dans le sang	:LVt
noyer le poisson	:LV
numéroter ses abattis	:LV
n’aller que par sauts et par bonds	:LV
n’avoir cure	:LVn
n’avoir de cesse	:LVi
n’avoir d’yeux et d’oreilles que pour	:LV
n’avoir d’yeux que pour	:LV
n’avoir garde de	:LVt
n’avoir jamais perdu de vue le clocher de son village	:LV
n’avoir jamais vu péter le loup sur la pierre de bois	:LV
n’avoir ni feu ni lieu	:LV
n’avoir ni honte ni vergogne	:LV
n’avoir ni queue ni tête	:LV
n’avoir ni sou ni maille	:LV
n’avoir pas de tête	:LVi
n’avoir pas le sou	:LV
n’avoir pas les gants	:LVi
n’avoir pas où reposer sa tête	:LV
n’avoir pas sa langue dans sa poche	:LV
n’avoir pas son pareil	:LV
n’avoir pas un poil de sec	:LV
n’avoir pas un sou	:LV
n’avoir pas un sou vaillant	:LV
n’avoir plus de quoi frire	:LVi
n’avoir plus que ses yeux pour pleurer	:LV
n’avoir que faire	:LVi
n’avoir que la peau et les os	:LV
n’avoir que la peau sur les os	:LV
n’avoir qu’un souffle de vie	:LV
n’avoir qu’une parole	:LV
n’avoir qu’à	:LV
n’avoir qu’à se baisser et à prendre	:LVi
n’avoir rien contre	:LV
n’avoir rien d’humain que le visage	:LV
n’avoir rien qui vaille	:LV
n’avoir rien à envier	:LV
n’avoir rien à frire	:LV
n’avoir rien à se mettre sous la dent	:LV
n’avoir rien à voir	:LV
n’avoir vu que le clocher de son village	:LV
n’en avoir rien à battre	:LV
n’en avoir rien à branler	:LV
n’en avoir rien à carrer	:LV
n’en avoir rien à cirer	:LV
n’en avoir rien à foutre	:LV
n’en avoir rien à secouer	:LV
n’en avoir rien à swinguer	:LV
n’en avoir rien à taper	:LV
n’en faire qu’une bouchée	:LV
n’en faire qu’à sa tête	:LV
n’en pas faire à deux fois	:LVi
n’en pas finir	:LVi
n’en plus finir	:LVi
n’en plus pouvoir	:LVi
n’en pouvoir mais	:LV
n’en rien faire	:LVi
n’y avoir ni honneur ni profit	:LVm
n’y manquer que la parole	:LVi
n’y voir que du bleu	:LV
n’y voir que du feu	:LV
n’écouter que d’une oreille	:LV
n’épargner le poitou	:LV
n’épargner personne	:LV
n’être autre que	:LV
n’être bon ni à rôtir, ni à bouillir	:LV
n’être même pas bon à jeter aux chiens	:LV
n’être pas rendu	:LVi
n’être plus	:LV
n’être qu’un cœur et qu’une âme	:LVi
n’être qu’à l’alphabet	:LV
observer le silence	:LV
occuper (s’) de ses oignons	:LV
occuper le devant de la scène	:LV
occuper le terrain	:LV
offrir aux yeux	:LVip
offrir en pâture	:LV
on aurait dit	:LV
on dirait	:LV
on dit	:LN:m|:LV
onduler de la toiture	:LV
opiner de la culotte	:LV
opiner du bonnet	:LV
opiner du chef	:LV
opiner du cul	:LV
oser se montrer	:LV
oublier d’être con	:LV
ouvrir de grands yeux	:LVi
ouvrir des horizons	:LV
ouvrir la bouche	:LVi
ouvrir la boîte de pandore	:LV
ouvrir la champlure	:LV
ouvrir la porte	:LVn
ouvrir la voie	:LV
ouvrir la(les) porte(s)	:LV
ouvrir le ban	:LV
ouvrir le feu	:LVn
ouvrir le parapluie	:LV
ouvrir les bras	:LVn
ouvrir les cadeaux avant noël	:LV
ouvrir les oreilles	:LVn
ouvrir les yeux	:LV|:LV:p
ouvrir l’appétit	:LVi
ouvrir l’esprit	:LVi
ouvrir l’oreille	:LVn
ouvrir l’œil	:LV:s
ouvrir sa bourse	:LVn
ouvrir sa maison	:LVn
ouvrir ses oreilles	:LV
ouvrir ses oreilles toutes grandes	:LV
ouvrir ses portes	:LV
ouvrir ses épaules	:LV
ouvrir son cœur	:LV
ouvrir son âme	:LV
ouvrir un avis	:LVn
ouvrir un compte	:LVi
ouvrir un crédit	:LVn
ouvrir une carrière	:LV
ouvrir une parenthèse	:LV
ouïr dire	:LV
parachuter un sénégalais	:LV
parer au plus pressé	:LV
parler au cœur	:LV
parler aux murs	:LV
parler avec les mains	:LV
parler boutique	:LV
parler chiffon	:LV
parler chiffons	:LV
parler chrétien	:LN:m|:LV
parler comme un aveugle des couleurs	:LVi
parler comme un charretier	:LV
parler comme un livre	:LVi
parler comme un perroquet	:LVi
parler cru	:LV
parler dans le désert	:LVi
parler dans le sens de	:LV
parler dans le vide	:LV
parler dans sa barbe	:LV
parler dans sa moustache	:LV
parler de la pluie et du beau temps	:LV
parler de soi-même	:LVi
parler de tout et de rien	:LV
parler d’abondance	:LV
parler d’or	:LVi
parler en l’air	:LVi
parler en maître	:LVi
parler entre ses dents	:LV
parler français comme une vache espagnole	:LV
parler haut	:LVi
parler juste	:LVi
parler pour ne rien dire	:LN:m|:LV
parler pour parler	:LVi
parler à coeur ouvert	:LV
parler à cœur ouvert	:LV
parler à l’oreille	:LV
parler à mots couverts	:LV
parler à son bonnet	:LVi
parler à tort et à travers	:LVi
parler à travers son chapeau	:LV
parler à un mur	:LVi
parler à un sourd	:LVi
partager en deux	:LV
partir comme des petits pains	:LV
partir de la main	:LN:m|:LV
partir du bon pied	:LV
partir du mauvais pied	:LV
partir du pied gauche	:LV
partir en biberine	:LV
partir en cacahouète	:LV
partir en cacahuète	:LV
partir en couille	:LV
partir en fumée	:LV
partir en live	:LV
partir en quenouille	:LV
partir en sucette	:LV
partir en vrille	:LV
partir la paille au cul	:LV
partir les pieds devant	:LV
partir sans demander son reste	:LV
partir sur le pouce	:LV
partir à hue et à dia	:LV
passer au bleu	:LV
passer au crible	:LV
passer au fil de l’épée	:LV
passer au laminoir	:LV
passer au peigne fin	:LVt
passer commande	:LVi
passer comme une lettre à la poste	:LV
passer comme une ombre	:LV
passer de la pommade	:LVn
passer de mode	:LV
passer de vie à trépas	:LVi
passer des nuits sur la corde à linge	:LV
passer du coq à l’âne	:LV
passer du noir au blanc	:LV
passer en revue	:LVt
passer entre les gouttes	:LV
passer inaperçu	:LV
passer la brosse à reluire	:LV
passer la main	:LV
passer la main dans le dos	:LV
passer la mer aux harengs	:LV
passer la nuit	:LVi
passer la nuit sur la corde à linge	:LVi
passer la surmultipliée	:LV
passer le flambeau	:LV
passer le mot	:LV
passer le rubicon	:LV
passer le temps	:LV
passer l’arme à gauche	:LV
passer l’aspirateur	:LVi
passer l’expression	:LV
passer l’éponge	:LVi
passer maître	:LV
passer outre	:LVit
passer par la tête	:LV
passer par le creuset	:LV
passer par les armes	:LVi
passer par les baguettes	:LVt
passer par les mains	:LV
passer par toutes les couleurs (de l’arc-en-ciel)	:LV
passer permission	:LVi
passer pour	:LV:i
passer pour une bille	:LV
passer sa vie	:LVi
passer ses nerfs	:LV
passer ses nerfs sur	:LV
passer son chemin	:LVt
passer sous le bureau	:LVi
passer sous le nez	:LVi
passer sous les fourches caudines	:LVt
passer sous silence	:LVt
passer sur le billard	:LV
passer sur le ventre	:LV
passer un appel	:LVn
passer un cap	:LV
passer un coup de fer	:LV
passer un coup de fil	:LVn
passer un coup de téléphone	:LVn
passer un examen	:LV
passer un mauvais quart d’heure	:LVi
passer un québec	:LV
passer un sale moment	:LV
passer un sapin	:LV
passer un savon	:LVt
passer à autre chose	:LV
passer à cheval	:LV
passer à gué	:LVt
passer à la casserole	:LV
passer à la moulinette	:LV
passer à la trappe	:LVit
passer à l’alambic	:LV
passer à l’as	:LV
passer à l’aspirateur	:LVt
passer à l’huche	:LV
passer à tabac	:LV
passer à travers les mailles du filet	:LV
payer avec un lance-pierre	:LV
payer cher	:LV
payer de sa personne	:LV
payer de sa poche	:LV
payer de sa tête	:LVt
payer en monnaie de singe	:LV
payer la camuse	:LV
payer la folle enchère	:LVi
payer le prix fort	:LV
payer les pots cassés	:LV
payer les violons	:LV
payer l’endosse	:LV
payer rubis sur l’ongle	:LV
payer sa dette à la nature	:LV
payer son écot	:LV
payer tribut	:LVi
payer un verre	:LV
peigner la girafe	:LV
peindre à fresque	:LV
peler le jonc	:LV
pelleter par en avant	:LV
peloter en attendant partie	:LV
pendre haut et court	:LVt
pendre la crémaillère	:LV
pendre à l’oreille	:LV
penser avec sa bite	:LVi
penser avec sa queue	:LVi
penser tout haut	:LVi
percer le cœur	:LV
percer à jour	:LV
perdre connaissance	:LV
perdre conscience	:LV
perdre contenance	:LVi
perdre de vue	:LVi
perdre du temps	:LVi
perdre du terrain	:LVi
perdre haleine	:LV
perdre la boule	:LV
perdre la boussole	:LV
perdre la carte	:LVi
perdre la face	:LV
perdre la main	:LV
perdre la parole	:LVi
perdre la raison	:LV
perdre la respiration	:LV
perdre la tramontane	:LVi
perdre la tête	:LVi
perdre la vie	:LVi
perdre le boire et le manger	:LVi
perdre le fil	:LV
perdre le nord	:LV
perdre les eaux	:LV
perdre les pédales	:LV
perdre l’haleine	:LV
perdre pied	:LV
perdre sa fleur	:LV
perdre sa peine	:LV
perdre ses billes	:LV
perdre ses esprits	:LV
perdre ses moyens	:LV
perdre ses nerfs	:LV
perdre son chemin	:LV
perdre son latin	:LVi
perdre son sang froid	:LVi
perdre son temps	:LV
perdre terre	:LV
peser au trébuchet	:LV
peser dans la balance	:LV
peser le pour et le contre	:LV
peser ses mots	:LV
peser sur le cœur	:LVi
peser un âne mort	:LV
peser à la main	:LV
peu importer	:LVim
piler de l’eau dans un mortier	:LV
pincer au demi-cercle	:LVt
pincer le vent	:LV
piquer au vif	:LV
piquer des deux	:LV
piquer du nez	:LV
piquer d’honneur	:LVt
piquer la curiosité	:LV
piquer les yeux	:LVi
piquer un fard	:LV
piquer un roupillon	:LV
piquer un soleil	:LV
piquer un somme	:LV
piquer une crise	:LV
piquer une jasette	:LV
piquer une tête	:LV
pisser dans son froc	:LV
pisser dans un violon	:LV
pisser de la copie	:LVi
pisser de rire	:LV
pisser des lignes de code	:LV
pisser le sang	:LV
pisser sa côtelette	:LV
pisser à la raie	:LV
place au soleil	:LV
placer quelqu’un sur un piédestal	:LV
placer ses pions	:LV
plaindre ses pas	:LV
planter le drapeau	:LV
planter le javelot dans la moquette	:LV
planter son drapeau	:LV
pleurer comme une madeleine	:LVi
pleurer misère	:LV
pleurer toutes les larmes de son corps	:LVi
pleurer à chaudes larmes	:LVi
pleuvoir comme une vache qui pisse	:LV
pleuvoir comme vache qui pisse	:LVim
pleuvoir comme à gravelotte	:LV
pleuvoir des cordes	:LVim
pleuvoir des hallebardes	:LVim
pleuvoir à boire debout	:LVim
pleuvoir à flots	:LVim
pleuvoir à seaux	:LVim
pleuvoir à torrent	:LV
pleuvoir à verse	:LV
plier bagage	:LV
plier les gaules	:LV
plier l’échine	:LVi
plier son parapluie	:LV
ployer l’échine	:LV
plumer la poule sans la faire crier	:LVi
plus que ça, tu meurs	:LV
pogner de quoi	:LV
pogner le fixe	:LV
pogner les nerfs	:LV
pogner un nœud	:LV
pogner une coche	:LV
poignarder dans le dos	:LVt
pomper le dard	:LV
pomper le gland	:LV
pomper le noeud	:LV
pomper l’air	:LVi
porter abonde	:LV
porter affection	:LV
porter amitié	:LV
porter assistance	:LVn
porter atteinte	:LVn
porter au pinacle	:LV
porter aux nues	:LVi
porter bateau	:LVi
porter beau	:LVi
porter bien la voile	:LVi
porter bonheur	:LV
porter coup	:LV
porter dans son cœur	:LVi
porter de la toile	:LVi
porter de l’eau à la rivière	:LV
porter des cornes	:LV
porter des paroles	:LVi
porter en terre	:LVt
porter en triomphe	:LVt
porter envie	:LVi
porter haut la tête	:LVi
porter la culotte	:LV
porter la livrée	:LVi
porter la maffre	:LV
porter la main	:LV
porter la parole	:LVi
porter la peine	:LVi
porter la poisse	:LV
porter la robe	:LVi
porter la santé	:LV
porter la soutane	:LVi
porter la tiare	:LVi
porter le chapeau	:LV
porter le deuil	:LVi
porter le doule	:LVi
porter le fer dans la plaie	:LV
porter le froc	:LVi
porter le joug	:LVi
porter le nez au vent	:LVi
porter le petit collet	:LVi
porter les armes	:LV
porter les couleurs	:LVi
porter l’épée	:LVi
porter mal la voile	:LVi
porter malheur	:LVi
porter ombrage	:LVi
porter ombre	:LVi
porter plainte	:LV
porter plein	:LV
porter préjudice	:LVi
porter remède à	:LV
porter sa croix	:LV
porter sa tête sur l’échafaud	:LVi
porter sa vue	:LVi
porter sa vue bien loin	:LV
porter secours	:LVi
porter ses pas	:LVi
porter ses regards	:LVi
porter ses vues bien haut	:LVi
porter son excuse avec soi	:LVi
porter son ombre	:LVi
porter son regard	:LVi
porter sur le système	:LV
porter sur les fonts baptismaux	:LV
porter sur les nerfs	:LVi
porter sur l’oreille	:LVt
porter témoignage	:LVi
porter un jugement	:LVi
porter un toast	:LV
porter une santé	:LV
porter à confusion	:LV
porter à croire	:LV
porter à cru	:LVi
porter à faux	:LVi
porter à fond	:LVi
porter à la tête	:LVi
porter à l’écran	:LV
poser des jalons	:LV
poser en fait	:LV
poser le genou	:LV
poser les armes	:LV
poser les yeux	:LV
poser ses valises	:LV
poser sur chant	:LV
poser un lapin	:LVi
poser une colle	:LV
poser une pêche	:LV
pourrir la gueule	:LV
poursuivre son bonhomme de chemin	:LV
pousser au noir	:LN:m|:LV
pousser comme des champignons	:LV
pousser comme du chiendent	:LV
pousser comme un champignon	:LV
pousser des cris d’orfraie	:LV
pousser du bois	:LVi
pousser la chansonnette	:LV
pousser le bois	:LVi
pousser le bouchon	:LV
pousser le bouchon loin	:LV
pousser le bouchon un peu loin	:LV
pousser le repas de la veille	:LV
pousser le trait	:LV
pousser les hauts cris	:LVi
pousser mémé dans les orties	:LV
pousser une gueulante	:LV
pousser à bout	:LVt
pousser à la roue	:LV
pouvoir aller se rhabiller	:LV
pouvoir en dire des nouvelles	:LVn
pouvoir passer derrière une affiche sans la décoller	:LV
pouvoir toujours courir	:LV
prendre (avec) des gants	:LV
prendre acte	:LVi
prendre amener	:LV
prendre appui	:LV
prendre au berceau	:LV
prendre au collet	:LV
prendre au dépourvu	:LVt
prendre au mot	:LV
prendre au pied de la lettre	:LVt
prendre au pied levé	:LVt
prendre au saut du lit	:LVt
prendre au sérieux	:LVi
prendre au trébuchet	:LVt
prendre aux entrailles	:LVt
prendre aux tripes	:LV
prendre avis	:LVi
prendre chair	:LVi
prendre chasse	:LVt
prendre cher	:LV
prendre congé	:LVi
prendre connaissance	:LVi
prendre conscience	:LV
prendre contact	:LVi
prendre corps	:LV
prendre couleur	:LVi
prendre courage	:LVi
prendre dans ses filets	:LVi
prendre date	:LVi
prendre de court	:LV
prendre de force	:LVt
prendre de haut	:LVt
prendre de la bouteille	:LV
prendre de la vitesse	:LVi
prendre de l’avance	:LVi
prendre de l’empire sur soi-même	:LV
prendre de l’âge	:LVi
prendre de plus haut	:LVt
prendre de toutes mains	:LVt
prendre de vitesse	:LVt
prendre des airs	:LVi
prendre des cartes	:LVi
prendre des couleurs	:LV
prendre des gants	:LV
prendre des grands airs	:LV
prendre des informations	:LVi
prendre des libertés	:LVi
prendre des mesures	:LVi
prendre des notes	:LV
prendre des proportions	:LVi
prendre des renseignements	:LVi
prendre des ris	:LVi
prendre des vessies pour des lanternes	:LV
prendre deux secondes	:LVi
prendre du bon côté	:LVt
prendre du bon temps	:LV
prendre du champ	:LV
prendre du délai	:LVi
prendre du galon	:LV
prendre du grade	:LV
prendre du jus	:LV
prendre du mauvais côté	:LVt
prendre du poison	:LVi
prendre du recul	:LV
prendre du repos	:LVi
prendre du souci	:LV
prendre du temps	:LVi
prendre d’assaut	:LVt
prendre en bonne part	:LVt
prendre en charge	:LV
prendre en chasse	:LVt
prendre en compte	:LVt
prendre en considération	:LVt
prendre en fabrique	:LV
prendre en faute	:LVt
prendre en filature	:LVt
prendre en flagrant délit	:LVt
prendre en grippe	:LV
prendre en gré	:LV
prendre en main	:LVi
prendre en mauvaise part	:LVt
prendre en photo	:LVt
prendre en pitié	:LVt
prendre en riant	:LVt
prendre en sandwich	:LV
prendre en tenaille	:LV
prendre en toute rigueur	:LVt
prendre en traitre	:LV
prendre exemple	:LVi
prendre fait et cause	:LVi
prendre façade	:LVi
prendre femme	:LVi
prendre feu	:LVi
prendre fin	:LVi
prendre forme	:LVi
prendre froid	:LV
prendre garde	:LV
prendre goût	:LVi
prendre haleine	:LVi
prendre hauteur	:LVi
prendre intérêt	:LVi
prendre jour	:LVi
prendre la balle au bond	:LVi
prendre la balle de volée	:LVi
prendre la balle à la volée	:LVi
prendre la bonne voie	:LVi
prendre la bûche	:LVi
prendre la clef (cle) des champs	:LV
prendre la clef des champs	:LVi
prendre la clé des champs	:LV
prendre la cornette	:LVi
prendre la couchette	:LV
prendre la croix	:LV
prendre la discipline	:LVi
prendre la file	:LVi
prendre la fuite	:LVi
prendre la grosse tête	:LV
prendre la haire	:LVi
prendre la haute mer	:LVi
prendre la hauteur du soleil	:LVi
prendre la liberté	:LVi
prendre la ligne 11	:LV
prendre la livrée	:LVi
prendre la lune avec les dents	:LV
prendre la main dans le pot de nutella	:LVt
prendre la main dans le sac	:LVt
prendre la mauvaise voie	:LVi
prendre la mer	:LV
prendre la mouche	:LVi
prendre la parole	:LVi
prendre la peine de	:LV
prendre la porte	:LV
prendre la poudre d’escampette	:LVi
prendre la robe	:LVi
prendre la tangente	:LVi
prendre la température	:LV
prendre la tête	:LV
prendre la tête à papineau	:LV
prendre la vache et le veau	:LV
prendre la volée	:LV
prendre langue	:LVi
prendre le bonnet	:LVi
prendre le carême de trop haut	:LVi
prendre le change	:LVi
prendre le chemin	:LVi
prendre le chemin des filets	:LV
prendre le chou	:LV
prendre le dessus	:LVi
prendre le deuil	:LVi
prendre le doigt dans le pot de confiture	:LV
prendre le frais	:LVi
prendre le froc	:LVi
prendre le galop	:LVi
prendre le gauche	:LVi
prendre le haut bout	:LVi
prendre le large	:LVi
prendre le lit	:LVi
prendre le mal à la racine	:LV
prendre le maquis	:LV
prendre le meilleur	:LV
prendre le mors aux dents	:LVi
prendre le p2	:LV
prendre le pas	:LVi
prendre le petit collet	:LVi
prendre le plaisir	:LVi
prendre le pli	:LV
prendre le pli de	:LV
prendre le plus court	:LVi
prendre le plus long	:LVi
prendre le pouls	:LV
prendre le quart	:LV
prendre le relai	:LV
prendre le relais	:LV
prendre le sel	:LVi
prendre le taureau par les cornes	:LV
prendre le temps	:LVi
prendre le temps comme il vient	:LVi
prendre le tournant	:LV
prendre le train en marche	:LV
prendre le trot	:LVi
prendre le vent	:LV
prendre le voile	:LVi
prendre les armes	:LVi
prendre les choses comme elles viennent	:LVi
prendre les choses en main	:LV
prendre les devants	:LVi
prendre les eaux	:LV
prendre les hommes comme ils sont	:LVi
prendre les ordres	:LVi
prendre les voiles	:LV
prendre légèrement	:LVi
prendre l’accourcie	:LV
prendre l’air	:LVi
prendre l’aspiration	:LV
prendre l’eau	:LV
prendre l’habit	:LVi
prendre l’occasion aux cheveux	:LVi
prendre l’ordre	:LVi
prendre martre pour renard	:LV
prendre mesure	:LVi
prendre médecine	:LVi
prendre naissance	:LVi
prendre note	:LVi
prendre occasion	:LVi
prendre off	:LV
prendre ombrage	:LV
prendre par force	:LVt
prendre par la famine	:LV
prendre par le plus court	:LVi
prendre par le plus long	:LVi
prendre par son faible	:LVt
prendre part	:LV
prendre parti	:LVi
prendre patience	:LVi
prendre peine	:LVi
prendre perpette	:LV
prendre pied	:LVi
prendre pitié	:LVi
prendre place	:LVi
prendre plaisir	:LVi
prendre port	:LVi
prendre position	:LVi
prendre possession	:LVn
prendre pour	:LVt
prendre pour acquis	:LV
prendre pour argent comptant	:LVt
prendre pour femme	:LVt
prendre pour mari	:LVt
prendre pour soi	:LVi
prendre pour un américain	:LV
prendre pour un lapin de six semaines	:LVt
prendre pour une bille	:LV
prendre prétexte	:LVi
prendre que	:LV
prendre racine	:LV
prendre rang	:LVi
prendre sa bonne part	:LVi
prendre sa droite	:LVi
prendre sa gauche	:LVi
prendre sa retraite	:LV
prendre sa revanche	:LVi
prendre sa source	:LVi
prendre sans vert	:LVt
prendre ses aises	:LV
prendre ses cliques et ses claques	:LV
prendre ses degrés	:LVi
prendre ses désirs pour des réalités	:LV
prendre ses gouttes	:LVi
prendre ses jambes à son cou	:LV
prendre ses mesures	:LVi
prendre ses précautions	:LVi
prendre ses quartiers d’hiver	:LVi
prendre ses sûretés	:LVi
prendre soin	:LVi
prendre son briquet	:LV
prendre son courage à deux mains	:LVi
prendre son cours	:LVi
prendre son cœur à deux mains	:LVi
prendre son envol	:LVi
prendre son essor	:LVi
prendre son mal en patience	:LVi
prendre son parti	:LVi
prendre son parti de	:LV
prendre son pied	:LV
prendre son pli	:LVi
prendre son temps	:LVi
prendre son vol	:LVi
prendre son vol trop haut	:LV
prendre son élan	:LVi
prendre sous sa protection	:LVt
prendre sous son aile	:LV
prendre sous son bonnet	:LV
prendre sur le fait	:LVt
prendre sur soi	:LVit
prendre séance	:LVi
prendre sérieusement	:LVi
prendre terre	:LVi
prendre tournure	:LVi
prendre un air entendu	:LV
prendre un bol d’air	:LV
prendre un bon tour	:LVi
prendre un divertissement	:LVi
prendre un engagement	:LVi
prendre un intérêt	:LVi
prendre un mauvais tour	:LVi
prendre un nouveau départ	:LV
prendre un parti	:LVi
prendre un siège	:LVi
prendre un va-te-laver	:LV
prendre un verre	:LV
prendre un virage à la corde	:LV
prendre un vol trop haut	:LVi
prendre une attitude	:LVi
prendre une bonne tournure	:LVi
prendre une brosse	:LV
prendre une bâche	:LV
prendre une bûche	:LVi
prendre une caisse	:LV
prendre une cuite	:LV
prendre une douche	:LV
prendre une débarque	:LV
prendre une déculottée	:LV
prendre une détermination	:LVi
prendre une femme	:LVi
prendre une gamelle	:LV
prendre une idée	:LV
prendre une mauvaise tournure	:LVi
prendre une murge	:LV
prendre une pelle	:LV
prendre une pinte de bon sang	:LV
prendre une piquette	:LV
prendre une posture	:LVi
prendre une résolution	:LVi
prendre une veste	:LV
prendre une volée	:LV
prendre à bail	:LVt
prendre à cens	:LVt
prendre à contre-poil	:LVi
prendre à cœur	:LVt
prendre à ferme	:LVt
prendre à forfait	:LVt
prendre à intérêt	:LVt
prendre à la gorge	:LV
prendre à la lettre	:LVt
prendre à la tâche	:LVt
prendre à part	:LVt
prendre à partie	:LVt
prendre à pied la route	:LV
prendre à pleine main	:LVt
prendre à pleines mains	:LVt
prendre à ses risques et périls	:LVt
prendre à ses risques, périls et fortunes	:LV
prendre à toutes mains	:LVt
prendre à travers champs	:LVi
prendre à travers les terres labourées	:LVi
prendre à tâche	:LVi
prendre à témoin	:LVt
prends ton courage à deux mains mon cousin	:LV
presser comme un citron	:LV
presser le citron	:LV
presser le mouvement	:LVt
priver de dessert	:LV
promettre la lune	:LV
promettre monts et merveilles	:LVi
promettre plus de beurre que de pain	:LVi
promettre un chien de sa chienne	:LV
proposer la botte	:LV
prouver par a + b	:LV
prouver par a plus b	:LV
présenter les armes	:LV
présumer de ses forces	:LV
prêcher dans le désert	:LVi
prêcher d’exemple	:LVi
prêcher le faux pour savoir le vrai	:LV
prêcher l’avent	:LV
prêcher pour sa paroisse	:LV
prêcher pour son saint	:LVi
prêcher un convaincu	:LV
prêcher un converti	:LV:m:s
prêter assistance	:LVn
prêter attention	:LV
prêter la main à	:LV
prêter le flanc	:LVi
prêter l’oreille	:LV
prêter main forte	:LVn
prêter main-forte	:LVn
prêter sa plume	:LV
prêter secours	:LVn
prêter serment	:LV
prêter une oreille amusée	:LV
prêter une oreille indulgente	:LV
prêter à confusion	:LV
prêter à la petite semaine	:LV
prêter à rire	:LVi
publier les bans	:LVi
pédaler dans la cancoillotte	:LV
pédaler dans la choucroute	:LV
pédaler dans la semoule	:LV
pédaler dans le couscous	:LV
pédaler dans le yaourt	:LV
pétage de câble	:LV:m:s
pétages de câble	:LV:m:p
péter au frette	:LV
péter dans la soie	:LVi
péter de la broue	:LV
péter des scores	:LV
péter la forme	:LV
péter la rondelle	:LV
péter le boulard	:LV
péter le cul	:LV
péter le feu	:LV
péter les couilles	:LV
péter les oreilles	:LV
péter les plombs	:LVi
péter plus haut que le trou	:LV
péter plus haut que son cul	:LV
péter un câble	:LVi
péter un fusible	:LVi
péter un plomb	:LV
péter une coche	:LV
péter une durite	:LVi
péter à la gueule	:LVn
pêcher en eau trouble	:LVi
pêcher à la luminade	:LV:f
quitter la partie	:LV
quitter la table	:LV
quitter le brodequin pour prendre le cothurne	:LV
qu’ainsi ne soit	:LV
rabattre la huppe	:LV
rabattre le caquet à	:LV
raccrocher au nez	:LVt
raccrocher les wagons	:LV
raccrocher à la gueule	:LV
racler les fonds de tiroirs	:LV
raconter des cracks	:LV
raconter des craques	:LV
raconter des histoires	:LV
raconter des salades	:LV
rafraîchir la mémoire	:LV
rafraîchir le sang	:LV
rajouter une couche	:LV
ralentir le mouvement	:LVt
rallier au vent	:LV
rallier le vent	:LV
rallumer la chaudière	:LV
ramasser le gant	:LV
ramener au bercail	:LV
ramener au bercail une brebis égarée	:LVi
ramener sa fraise	:LV
ramener sa gueule	:LVi
ramener son grain de sel	:LV
ramer les courges	:LVi
ramoner le trou de balle	:LV
rappeler à l’ordre	:LV
rare comme de la marde de pape	:LV
raser la terre	:LV
raser les murs	:LV
rater le coche	:LV
rater son coup	:LV
rater un éléphant dans un couloir	:LV
rater une vache dans un couloir	:LV
ratisser large	:LV
ratisser le bunker	:LV
rattraper le temps perdu	:LVi
ravaler sa fierté	:LV
rayer de la carte	:LVt
rayer de son carnet d’adresses	:LV
rayé des cadres	:LV
rebattre les oreilles	:LV
rebrousser chemin	:LVi
recentrer le débat	:LV
recevoir cinq sur cinq	:LV
recharger les accus	:LV
recharger les batteries	:LV
recoller les morceaux	:LV
recommencer de plus belle	:LVi
recommencer sur nouveaux frais	:LVt
recommencer à zéro	:LV
reconnaitre un enfant	:LV
reconnaître pour	:LV
reculer pour mieux sauter	:LV
reculé par le tonnerre	:LV
redorer son blason	:LV
refaire le monde	:LV
refaire le plein	:LV
refaire le portrait	:LV
refaire surface	:LV
refiler le bébé	:LV
refouler du goulot	:LV
refuser la main à	:LV
regagner ses pénates	:LV
regarder aux carreaux	:LVt
regarder avec des yeux de merlan frit	:LVt
regarder de côté	:LVt
regarder de haut en bas	:LVt
regarder de près	:LVt
regarder de quel côté vient le vent	:LVi
regarder de travers	:LVt
regarder d’un bon œil	:LVt
regarder d’un mauvais œil	:LVt
regarder en dessous	:LVt
regarder en face	:LVt
regarder en pitié	:LVt
regarder entre les yeux	:LVt
regarder favorablement	:LVt
regarder les mouches voler	:LV
regarder l’herbe pousser	:LVi
regarder par le petit bout de la lorgnette	:LV
regarder par-dessus l’épaule	:LV
regarder sous le nez	:LVt
regarder voler des coquecigrues	:LV
regarder à la dépense	:LVi
regretter ses pas	:LV
rejeter de souche	:LVi
relever la tête	:LV
relever le gant	:LV
remettre au jour	:LV
remettre au pas	:LVt
remettre aux calendes grecques	:LVt
remettre devant les yeux	:LVt
remettre en cause	:LV
remettre en honneur	:LV
remettre en question	:LVi
remettre en route	:LVt
remettre en valeur	:LV
remettre en état	:LV
remettre les compteurs à zéro	:LV
remettre les idées en place	:LV
remettre les pendules à l’heure	:LV
remettre les pieds	:LV
remettre sa carte	:LV
remettre sous les yeux	:LVt
remettre sur le tapis	:LVt
remettre sur pied	:LV
remettre à sa place	:LVt
remise en état	:LV:f
remonter au déluge	:LV
remonter grand-père au grenier	:LV
remonter la pente	:LV
remonter le canayen	:LV
remonter le courant	:LV
remonter le temps	:LV
remonter les bretelles	:LV
remonter plus haut	:LVi
remonter sur la bête	:LVi
remonter sur le trône	:LVi
remonter sur l’eau	:LVi
remonter à adam et ève	:LV
remuer ciel et terre	:LV
remuer de la terre	:LV
remuer la terre	:LV
remuer le couteau dans la plaie	:LV
remuer le fer dans la plaie	:LV
remuer les tripes	:LV
renaître de ses cendres	:LV
rencontrer un grain de sable	:LV
rendre avec usure	:LVt
rendre chèvre	:LV
rendre compte	:LVi
rendre des points	:LVn
rendre des soins	:LVi
rendre gorge	:LVi
rendre grâce	:LVn
rendre haleine	:LV
rendre hommage	:LV
rendre la boule	:LV
rendre la monnaie (de sa pièce)	:LV
rendre la monnaie de sa pièce	:LV
rendre la pareille	:LVn
rendre la vie impossible	:LV
rendre le change	:LV
rendre le dernier soupir	:LVi
rendre les armes	:LV
rendre l’antenne	:LV
rendre l’âme	:LV
rendre public	:LV
rendre service	:LV
rendre son tablier	:LV
rendre son âme à dieu	:LVi
rendre visite	:LVt
rendre à césar ce qui appartient à césar	:LV
rendre à césar ce qui est à césar	:LV
rendre à quelqu’un la monnaie de sa pièce	:LV
rentrer dans le giron	:LV
rentrer dans le lard	:LV
rentrer dans le rang	:LV
rentrer dans le système	:LV
rentrer dans les ordres	:LV
rentrer dans sa coquille	:LV
rentrer dans un trou de souris	:LV
rentrer par une oreille et ressortir par l’autre	:LV
renverser la vapeur	:LV
renverser le jeu	:LV
renvoyer aux calendes grecques	:LV
renvoyer dans les cordes	:LV
renvoyer dos à dos	:LV
renvoyer la balle	:LVt
renvoyer la patate chaude	:LV
renvoyer l’ascenseur	:LV
renvoyer à l’alphabet	:LV
repartir comme en 14	:LVi
repartir comme en 40	:LVi
repartir comme en quarante	:LVi
repartir comme en quatorze	:LVi
repartir les pieds devant	:LV
repartir sur de bonnes bases	:LV
repartir à zéro	:LV
repousser du goulot	:LV
repousser ses limites	:LV
reprendre contact	:LVi
reprendre de plus haut	:LVt
reprendre du poil de la bête	:LV
reprendre du service	:LVi
reprendre en sous-œuvre	:LVt
reprendre haleine	:LVi
reprendre la mer	:LVi
reprendre langue	:LV
reprendre le collier	:LV
reprendre le dessus	:LVi
reprendre pied	:LVt
reprendre sa parole	:LVt
reprendre sa route	:LVi
reprendre ses esprits	:LV
reprendre son haleine	:LVi
reprendre son souffle	:LVi
reprendre sous œuvre	:LVt
reprendre une instance	:LVt
reprendre à son compte	:LV
reramener au bercail une brebis égarée	:LV
reramener sa fraise	:LV
resserrer les boulons	:LV
ressortir des boules à mites	:LVt
rester au milieu du gué	:LVi
rester coi	:LV
rester court	:LV
rester de marbre	:LVi
rester en compte	:LVi
rester en plan	:LV
rester en travers (de la gorge)	:LV
rester en travers de la gorge	:LV
rester ferme	:LV
rester groupir	:LV
rester les bras croisés	:LV
rester lettre morte	:LVi
rester maître	:LV
rester sec	:LV
rester sourd	:LVi
rester sur la touche	:LV
rester sur le billard	:LV
rester sur l’estomac	:LV
rester sur sa faim	:LV
rester à la traîne	:LV
retenir le bras	:LV
retenir sa respiration	:LV
retenir ses coups	:LV
retenir son souffle	:LV
retirer un serpent dans son sein	:LVi
retomber en enfance	:LV
retomber sur ses pattes	:LV
retomber sur ses pieds	:LV
retourner au charbon	:LV
retourner le cerveau	:LV
retourner le couteau dans la plaie	:LV
retourner le fer dans la plaie	:LV
retourner les tripes	:LV
retourner quelqu’un comme une vieille chaussette	:LV
retourner sa chemise	:LV
retourner sa veste	:LV
retourner sur ses pas	:LVi
retourner à ses moutons	:LV
retrousser les bras	:LV
retrousser ses manches	:LVi
revenir bredouille	:LV
revenir de loin	:LVi
revenir de l’autre monde	:LVi
revenir de mort à vie	:LVi
revenir de pontoise	:LVi
revenir en deuxième semaine	:LV
revenir sur la table	:LVi
revenir sur le passé	:LVi
revenir sur le tapis	:LV
revenir sur l’eau	:LVi
revenir sur ses pas	:LVi
revenir à dire	:LV
revenir à la case départ	:LV
revenir à la charge	:LVi
revenir à ses moutons	:LVi
revenir à soi	:LVi
revoir à la baisse	:LV
rhabiller les enfants	:LV
rigoler comme une baleine	:LVi
rimer comme hallebarde et miséricorde	:LV
rire aux anges	:LV
rire aux larmes	:LV
rire aux éclats	:LV
rire comme une baleine	:LVi
rire dans sa barbe	:LV
rire de bon cœur	:LV
rire jaune	:LV
rire sous cape	:LV
rire à gorge déployée	:LVi
rire à s’en décrocher la mâchoire	:LV
risquer le paquet	:LV
risquer sa peau	:LV
river son clou	:LV
river son clou à (qqn)	:LV
rogner les ailes	:LV
rompre des lances	:LVi
rompre en visière	:LVi
rompre la glace	:LVi
rompre la lance	:LVi
rompre la ligne	:LVi
rompre la paille	:LV
rompre la tête	:LVn
rompre le charme	:LVi
rompre le fer	:LV
rompre le pain	:LV
rompre le silence	:LVi
rompre les chemins	:LV
rompre les chiens	:LVi
rompre les oreilles	:LV
rompre les ponts	:LV
rompre les rangs	:LV
rompre l’eau à un cheval	:LVi
rompre sa lance	:LVi
rompre une lance	:LVi
ronger les sangs	:LV
ronger son frein	:LV
rouer de coups	:LVt
rouler bord sur bord	:LV
rouler dans la farine	:LVt
rouler des mécaniques	:LV
rouler des yeux	:LV
rouler dessus	:LV
rouler les mécaniques	:LV
rouler les r	:LV
rouler sa bosse	:LV
rouler sous la table	:LV
rouler sur l’or	:LV
rouler un palot	:LV
rouler un patin	:LV
rouler une galoche	:LV
rouler une pelle	:LV
roxer du poney	:LV
ruer dans les brancards	:LV
ruer en vache	:LV
réchauffer un serpent dans son sein	:LVi
récolter ce que l’on a semé	:LV
récurer la marmite	:LV
réduire au silence	:LVt
réduire en bouillie	:LV
réduire en cendres	:LV
réduire en miettes	:LV
réduire en poussière	:LV
réduire à rien	:LVt
régler son compte	:LVi
régner sans partage	:LV
réinventer la roue	:LV
réinventer la roue carrée	:LV
répandre comme la vérole sur le clergé	:LV
répandre des larmes	:LV
répandre le sang	:LV
répandre son sang	:LV
répondre au nom de	:LV
répondre à coté de la plaque	:LV
rétablir le fléau de la balance	:LVi
réunir les conditions	:LV
réveiller les vieux démons	:LV
révoquer en doute	:LV
rêver en couleur	:LV
rôtir le balai	:LV
sacrer la paix	:LV
sacrer le camp	:LV
sacrer là	:LV
sacrer patience	:LV
sacrer son camp	:LV
sacrer une volée	:LV
sacrifier aux grâces	:LV
sacrifier les apparences	:LV
saigner à blanc	:LV
saisir entre les mains	:LV
saisir la balle au bond	:LVi
saisir à bras-le-corps	:LV
saouler de fumée	:LVi
saper le moral	:LV
saprer le camp	:LV
sauter au collet	:LVi
sauter au cou	:LV
sauter aux yeux	:LV
sauter comme un cabri	:LV
sauter le mur	:LV
sauter le pas	:LVi
sauter sur l’occasion	:LVi
sauter une coche	:LV
sauter à la corde	:LV
sauter à pieds joints	:LV
sauver la face	:LV
sauver la mine	:LV
sauver les apparences	:LVi
sauver les meubles	:LV
sauver l’honneur	:LV
sauver sa peau	:LV
savoir bien le monde	:LVi
savoir ce que c’est	:LV
savoir ce que parler veut dire	:LVi
savoir ce qu’en vaut l’aune	:LV
savoir gré	:LVn
savoir la carte	:LV
savoir par cœur	:LVt
savoir prendre	:LVt
savoir son monde	:LVi
savoir s’y prendre	:LVi
savoir vivre	:LVi
savoir y faire	:LVi
savonner la planche	:LV
scier la branche sur laquelle on est assis	:LV
se battre comme des chiffonniers	:LV
se battre comme un lion	:LV
se battre contre des moulins à vent	:LV
se battre contre les moulins à vent	:LV
se battre en duel	:LV
se battre les flancs	:LV
se battre à armes égales	:LV
se bercer d’illusions	:LV
se beurrer la biscotte	:LV
se bouffer le nez	:LV
se bourrer la gueule	:LVp
se branler les couilles	:LV
se brûler les ailes	:LV
se brûler à la chandelle	:LV
se cailler les couilles	:LV
se cailler les miches	:LV
se calmer le pompon	:LV
se casser la binette	:LV
se casser la figure	:LV
se casser la gueule	:LV
se casser la margoulette	:LV
se casser la nénette	:LV
se casser la paillasse	:LV
se casser la tête	:LVn
se casser le bicycle	:LV:m
se casser le cul	:LV
se casser le nez	:LVp
se casser le tronc	:LV
se casser le ventre	:LV
se casser les couilles	:LV
se changer en	:LV
se changer les idées	:LV
se cirer le manche	:LV
se cogner la tête contre les murs	:LVi
se cogner le nez sur la porte	:LVp
se compliquer la vie	:LV
se composer le visage	:LV
se compter sur les doigts d’une main	:LV
se coucher avec les poules	:LV
se coucher comme les poules	:LV
se coucher moins niaiseux	:LV
se creuser la cervelle	:LV
se creuser la tête	:LV
se creuser les méninges	:LV
se croire le premier moutardier du pape	:LV
se croire sorti de la cuisse de jupiter	:LV
se croiser les bras	:LV
se crêper le chignon	:LV
se dire oui	:LV
se donner au diable	:LV
se donner bien du mouvement	:LVi
se donner carrière	:LV
se donner de l’air	:LV
se donner des gants	:LV
se donner du bon temps	:LVi
se donner du mal	:LV
se donner du mouvement	:LV
se donner en spectacle	:LVi
se donner la mort	:LV
se donner la peine	:LV
se donner le mot	:LV
se donner les gants	:LV
se donner pour	:LVt
se donner un mal de chien	:LV
se donner à fond	:LV
se défendre des lèvres	:LVp
se dégourdir les jambes	:LV
se déguiser en courant d’air	:LV
se démêler de	:LVt
se dépouiller du vieil homme	:LVi
se désenclaver la péninsule	:LV
se faire appeler arthur	:LV
se faire appeler joseph	:LV
se faire appeler jules	:LV
se faire appeler léon	:LV
se faire avoir	:LV
se faire baiser	:LV
se faire battre	:LV
se faire brasser le canayen	:LV
se faire buster	:LV
se faire carotte	:LV
se faire chauffer le cul	:LV
se faire connaître	:LVi
se faire de la bile	:LV
se faire des cheveux	:LV
se faire des cheveux blancs	:LV
se faire des couilles en or	:LV
se faire des fausses idées	:LVi
se faire des films	:LV
se faire des idées	:LV
se faire des illusions	:LV
se faire des nœuds au cerveau	:LV
se faire du mauvais sang	:LV
se faire du mouron	:LV
se faire désirer	:LVi
se faire enculer	:LV
se faire entuber	:LV
se faire eu	:LV
se faire fort de	:LV
se faire frotter les oreilles	:LV
se faire gauler	:LV
se faire hacher en pièces	:LV
se faire honneur	:LVp
se faire jour	:LVi
se faire la belle	:LVi
se faire la bite	:LV
se faire la main	:LV
se faire la malle	:LVi
se faire la paire	:LV
se faire les dents	:LV
se faire manger la cenne	:LV
se faire manger la graine	:LV
se faire marcher dessus	:LV
se faire menotte	:LV
se faire mousser	:LV
se faire offrir	:LV
se faire passer pour	:LV
se faire piétiner	:LV
se faire plaisir	:LV
se faire porter pâle	:LV
se faire pousser au cul	:LV
se faire prendre pour une valise	:LV
se faire péter la panse	:LV
se faire péter la sous-ventrière	:LVi
se faire ramasser	:LV
se faire rare	:LVi
se faire rattraper par son passé	:LV
se faire reconnaître	:LV
se faire regarder	:LVi
se faire reluire	:LV
se faire remonter les bretelles	:LVi
se faire renvoyer dans ses 22	:LV
se faire sauter la cervelle	:LV
se faire sauter le caisson	:LV
se faire son cinéma	:LVi
se faire sécher les dents	:LV
se faire taper sur les doigts	:LV
se faire tirer	:LV
se faire tirer le portrait	:LV
se faire tirer les oreilles	:LVi
se faire tirer l’oreille	:LV
se faire tout petit	:LV
se faire tout à tous	:LV
se faire trouer la peau	:LV
se faire turc	:LV
se faire un bleu	:LV
se faire un devoir	:LV
se faire un film	:LVi
se faire un nom	:LV
se faire un plaisir de	:LV
se faire un point d’honneur de	:LV
se faire un sang d’encre	:LV
se faire une fête	:LVi
se faire une loi	:LVi
se faire une place au soleil	:LV
se faire une raison	:LVi
se faire une toile	:LVi
se faire une tête	:LV
se faire vacher	:LV
se faire voir	:LV
se farcir la panse	:LV
se farcir une toile	:LVi
se fendre de	:LVt
se fendre la gueule	:LV
se fendre la pipe	:LV
se fendre la poire	:LV
se fendre la pêche	:LV
se fermer comme une huître	:LV
se forcer le cul	:LV
se fourrer le doigt dans l’oeil	:LV
se fourrer le doigt dans l’œil	:LV
se fourrer le doigt dans l’œil jusqu’au coude	:LV
se fourrer un doigt dans l’œil	:LV
se foutre de la gueule de	:LV
se foutre dedans	:LV
se foutre en l’air	:LV
se foutre sur la gueule	:LV
se friser les moustaches	:LV
se frotter les mains	:LVp
se fâcher tout rouge	:LV
se garder à carreau	:LV
se geler le croupion	:LVp
se geler le fion	:LVp
se geler les couilles	:LVp
se gercer le cul	:LV
se gratter la fesse	:LV
se gratter l’oreille	:LVi
se grouiller le cul	:LV
se gâter la main	:LV
se heurter à un mur	:LV
se heurter à un mur d’incompréhension	:LV
se jeter aux pieds	:LV
se jeter aux pieds de	:LV
se jeter dans la gueule du loup	:LV
se jeter dans les bras de	:LV
se jeter la tête la première	:LVi
se jeter à la nage	:LV
se jeter à la tête de	:LVt
se jeter à l’eau	:LV
se jouer de	:LVp
se la couler douce	:LV
se la donner	:LV
se la faire crème	:LV
se la jouer	:LVip
se la mettre derrière l’oreille	:LVi
se la péter	:LV
se la raconter	:LV
se la ramener	:LV
se la toucher	:LV
se laisser boire	:LV
se laisser faire	:LVi
se laisser gagner	:LVi
se laisser manger	:LV
se laisser manger la laine sur le dos	:LV
se laisser marcher sur les pieds	:LV
se laisser porter	:LV
se laisser prendre	:LV
se laisser prendre au piège	:LVi
se laisser prendre à l’hameçon	:LVi
se laisser vivre	:LV
se lancer des fleurs	:LV
se le tenir pour dit	:LV
se les briser menu	:LV
se les briser menues	:LV
se les cailler	:LVi
se les geler	:LV
se les peler	:LV
se lever de bonne heure	:LV
se lever de table	:LV
se lever du mauvais pied	:LV
se lever du pied gauche	:LV
se lâcher lousse	:LV
se lécher les babines	:LV
se magasiner une claque sur la gueule	:LV
se magner le cul	:LV
se manger les couilles	:LV
se manger les foies	:LV
se mettre au diapason	:LV
se mettre au vert	:LVi
se mettre carpette	:LV
se mettre dans la peau de	:LV
se mettre dans la tête	:LV
se mettre debout	:LV
se mettre du côté du manche	:LV
se mettre d’accord	:LV
se mettre en boule	:LV
se mettre en campagne	:LV
se mettre en colère	:LV
se mettre en demeure	:LV
se mettre en devoir de	:LV
se mettre en disponibilité	:LV
se mettre en frais	:LV
se mettre en peine	:LV
se mettre en porte-à-faux	:LV
se mettre en quatre	:LV
se mettre en tête	:LV
se mettre en évidence	:LV
se mettre la rate au court-bouillon	:LV
se mettre la tête	:LV
se mettre la tête sous le couperet	:LV
se mettre la tête à l’envers	:LV
se mettre le doigt dans l’œil	:LV
se mettre le doigt dans l’œil	:LV
se mettre le doigt dans l’œil jusqu’au coude	:LV
se mettre martel en tête	:LVi
se mettre minable	:LV
se mettre quelqu’un à dos	:LV
se mettre sur son trente et un	:LV
se mettre sur son trente-et-un	:LV
se mettre sur son trente-six	:LV
se mettre à la chotte	:LV
se mettre à l’aise	:LV
se mettre à l’eau	:LV
se mettre à l’œuvre	:LV
se mettre à table	:LVi
se mettre à tout	:LVi
se monter la tête	:LV
se monter le bobéchon	:LV
se monter le bourrichon	:LV
se montrer sous son meilleur jour	:LV
se moquer de la barbouillerie	:LV
se moquer de la barbouillée	:LV
se mordre la langue	:LV
se mordre les doigts	:LV
se morfiller le dardan	:LVp
se mélanger les pinceaux	:LV
se mélanger les pédales	:LV
se mêler de ses affaires	:LV
se mêler de ses oignons	:LV
se noyer dans un verre d’eau	:LV
se parer des plumes du paon	:LV
se partager le gâteau	:LV
se passer de	:LV
se passer de commentaires	:LV
se payer de mots	:LV
se payer la bobine	:LV
se payer la poire	:LV
se payer la poire de	:LV
se payer la traite	:LV
se payer la tête	:LVi
se payer le luxe	:LV
se payer par ses mains	:LV
se payer un platane	:LV
se payer une veste	:LV
se peinturer dans le coin	:LV
se peler le cul	:LV
se peler le jonc	:LV
se peler les couilles	:LV
se perdre dans des digressions	:LVi
se perdre dans les nuages	:LVi
se perdre dans les nues	:LVi
se perdre en conjectures	:LVi
se perdre les oies	:LV
se piquer au jeu	:LV
se piquer le nez	:LVp
se plaindre que la mariée est trop belle	:LVi
se pogner le cul	:LV
se pogner les mains	:LV
se polir le chinois	:LV
se porter comme le pont-neuf	:LV
se porter comme un charme	:LV
se porter fort	:LV
se porter garant	:LV:m:s
se porter garants	:LV:m:p
se pourlécher les babines	:LV
se pousser du col	:LV
se prendre aux cheveux	:LV
se prendre de bec	:LVi
se prendre de querelle	:LVi
se prendre la tête	:LVp
se prendre le chou	:LV
se prendre les pieds dans le tapis	:LV
se prendre par la main	:LV
se prendre par les oreilles	:LV
se prendre pour un autre	:LVp
se prendre un râteau	:LV
se prendre une gamelle	:LV
se prendre une veste	:LV
se prendre à	:LVt
se presser le citron	:LV
se péter les bretelles	:LV
se racler la soupière	:LV
se ranger des voitures	:LV
se rappeler au bon souvenir	:LV
se recommander à tous les saints du paradis	:LV
se refuser à l’évidence	:LV
se regarder en chiens de faïence	:LV
se regarder le nombril	:LV
se remettre en selle	:LV
se remettre entre les mains de	:LVt
se remettre à flot	:LV
se rendre compte	:LVt
se rendre coupable de	:LVp
se rendre maître	:LVn
se rendre utile	:LVi
se rendre à l’évidence	:LV
se repaître de fumée	:LVi
se replier dans sa coquille	:LVi
se reposer sur	:LV
se reposer sur ses lauriers	:LV
se retenir à quatre	:LVi
se retourner dans sa tombe	:LV
se retourner dans son cercueil	:LV
se retrousser les manches	:LV
se retrouver grosjean comme devant	:LV
se rincer l’oeil	:LV
se rincer l’œil	:LV
se rire dessus	:LV
se rompre la tête	:LVn
se ronger le cul à la vinaigrette	:LV
se ronger le cœur	:LVi
se ronger les ongles	:LV
se ronger les poings	:LVi
se rouler les pouces	:LV
se réconcilier sur l’oreiller	:LV
se saigner aux quatre veines	:LV
se salir les mains	:LV
se sentir d’attaque	:LVi
se sentir faim	:LV
se sentir les coudes	:LVp
se sentir pousser des ailes	:LV
se serrer la ceinture	:LV
se serrer les coudes	:LVp
se sortir bien	:LV
se sortir les doigts du cul	:LV
se sucrer le bec	:LV
se taper des barres	:LVi
se taper la cloche	:LV
se taper la honte	:LV
se taper la tête contre les murs	:LV
se taper le sale boulot	:LV
se taper l’affiche	:LV
se taper sur les cuisses	:LVi
se taper une queue	:LVp
se taquiner le bouton	:LV
se tenir au gros de l’arbre	:LV
se tenir coi	:LVi
se tenir derrière le rideau	:LVi
se tenir entre le mur et la peinture	:LV
se tenir les coudes	:LV
se tenir par la main	:LV
se tenir sur la brèche	:LV
se tenir à carreau	:LV
se tenir à carreaux	:LV
se tenir à la cape	:LVi
se tenir à quatre	:LVi
se tirer dans les pattes	:LVi
se tirer de la bagarre	:LV
se tirer de là	:LVi
se tirer d’affaire	:LVi
se tirer d’épaisseur	:LV
se tirer la bourre	:LV
se tirer une balle	:LV
se tirer une balle dans le pied	:LV
se tirer une bûche	:LV
se tordre de rire	:LVi
se tourner les pouces	:LV
se triturer la cervelle	:LV
se trouver bien	:LVi
se trouver en pays de connaissance	:LV
se trouver mal	:LVi
se trouver mieux	:LVi
se tâter le pouls	:LV
se vendre comme des petits pains	:LV
se vider les couilles	:LV
se voiler la face	:LV
se voir tous les jours	:LV
secouer comme un prunier	:LV
secouer la poussière	:LVn
secouer la poussière de ses souliers	:LVi
secouer le cocotier	:LV
secouer le joug	:LVn
secouer les oreilles	:LV
secouer les puces	:LV
semer la discorde	:LV
semer la zizanie	:LV
semer le doute	:LV
sentir bon	:LV
sentir la fièvre	:LV
sentir la naphtaline	:LV
sentir le brûlé	:LV
sentir le fagot	:LVi
sentir le fauve	:LV
sentir le roussi	:LV
sentir le sapin	:LV
sentir le soufre	:LV
sentir le terroir	:LVi
sentir le vent du boulet	:LV
sentir le vent tourner	:LV
sentir mauvais	:LVi
sentir pas bon	:LV
serrer de près	:LV
serrer la main	:LV
serrer la pince	:LV
serrer la vis	:LV
serrer le cœur	:LV
serrer le vent	:LVi
serrer les boulons	:LV
serrer les dents	:LV
serrer les rangs	:LV
servir de	:LVt
servir de pont	:LV
servir le couplet	:LV
ses cliques et ses claques	:LV
siffler comme un merle	:LV
signer de son sang	:LV
signer des deux mains	:LV
signer son arrêt de mort	:LV
sitôt pris, sitôt pendu	:LVi
songer à mal	:LVi
sonner bien à l’oreille	:LV
sonner faux	:LVi
sonner la curée	:LV
sonner la fin de la récréation	:LV
sonner le glas	:LV
sonner le tocsin	:LVi
sonner les cloches	:LV
sortir avec	:LV
sortir couvert	:LV
sortir de la tête	:LV
sortir de l’ombre	:LV
sortir de l’ordinaire	:LV
sortir de l’ornière	:LVi
sortir de prison	:LV
sortir de ses gonds	:LV
sortir des bornes	:LVi
sortir des boules à mites	:LVt
sortir des cartons	:LV
sortir des chemins battus	:LV
sortir des sentiers battus	:LV
sortir du bois	:LV
sortir du lot	:LV
sortir du placard	:LVi
sortir du rouge	:LV
sortir du ton	:LV
sortir ensemble	:LV
sortir hors de ses gonds	:LV
sortir hors des gonds	:LV
sortir la tête de l’eau	:LV
sortir le grand jeu	:LVi
sortir les griffes	:LV
sortir par la grande porte	:LV
sortir par la porte de tellier	:LV
sortir par la porte, entrer par la fenêtre	:LV
sortir par le haut	:LV
sortir par le nez	:LVi
sortir par les trous de nez	:LV
sortir par les yeux	:LVi
sortir tambour battant	:LV
souffler aux oreilles	:LVi
souffler comme un bœuf	:LV
souffler dans la manche	:LV
souffler dans le ballon	:LVi
souffler le chaud et le froid	:LV
souffler ses bougies	:LV
souffler à l’oreille	:LV
souffrir le martyre	:LVi
souffrir mort et passion	:LV
soulever le cœur	:LV
soupe de langue	:LV
souquer ferme	:LVi
souquer sur les avirons	:LVi
sourire jaune	:LV
subir un échec cuisant	:LV
sucer la pomme	:LV
sucer le sang	:LV
sucrer les fraises	:LV
suer comme un bœuf	:LV
suer d’ahan	:LV
suer sang et eau	:LV
suivre le mouvement	:LV
suivre les pas	:LV
suivre les traces	:LV
suivre sa pente	:LV
suivre son train de vie	:LV
sur la corde raide	:LV
sur la sellette	:LV
surveiller comme le lait sur le feu	:LV
surveiller ses arrières	:LV
surélever une orbite	:LV
sécher sur pied	:LV
séparer le bon grain de l’ivraie	:LV
s’acheter une conduite	:LV
s’affuter les crochets	:LV
s’affuter les crocs	:LV
s’affuter les gambilles	:LV
s’affuter les meules	:LV
s’affuter les pincettes	:LV
s’affuter les tabourets	:LV
s’affûter les crochets	:LVp
s’affûter les crocs	:LV
s’affûter les gambilles	:LV
s’affûter les meules	:LV
s’affûter les pincettes	:LV
s’affûter les tabourets	:LV
s’aider de	:LV
s’amuser à la moutarde	:LV
s’appeler reviens	:LV
s’appeler revient	:LV
s’armer de la lèvre	:LVp
s’arracher les cheveux	:LV
s’arracher les yeux	:LV
s’asseoir dessus	:LV
s’asseoir en indien	:LV
s’asseoir en tailleur	:LV
s’asseoir à l’indienne	:LV
s’astiquer le poireau	:LV
s’attacher aux pas de	:LV
s’attacher les services	:LV
s’emmerder la vie	:LV
s’emmêler les crayons	:LV
s’emmêler les pinceaux	:LV
s’en aller	:LV
s’en aller au diable	:LVp
s’en aller avec les feuilles	:LV
s’en aller en fumée	:LV
s’en aller les pieds devant	:LV
s’en badigeonner les testicules avec le pinceau de l’indifférence	:LV
s’en balancer	:LV
s’en battre	:LV
s’en battre lec	:LVi
s’en battre les couilles	:LV
s’en battre les reins	:LV
s’en battre les steaks	:LVi
s’en battre l’œil	:LV
s’en branler	:LV
s’en branler comme de l’an quarante	:LV
s’en cogner	:LV
s’en contreficher	:LV
s’en câlisser	:LV
s’en donner à cœur joie	:LV
s’en faire	:LVp
s’en ficher	:LV
s’en ficher comme de l’an quarante	:LV
s’en fourrer jusque-là	:LV
s’en foutre	:LV
s’en foutre comme de l’an quarante	:LV
s’en foutre et s’en contrefoutre	:LV
s’en griller une	:LV
s’en laisser conter	:LV
s’en laver les mains	:LV
s’en mettre plein la gueule	:LV
s’en mettre plein la lampe	:LV
s’en mettre plein les poches	:LV
s’en moquer comme de l’an quarante	:LV
s’en mordre les doigts	:LV
s’en mordre les lèvres	:LV
s’en prendre plein la gueule	:LV
s’en prendre une	:LV
s’en prendre à	:LVt
s’en remettre à	:LV
s’en renvenir	:LVp
s’en ressentir	:LVip
s’en retourner	:LV
s’en revenir	:LVi
s’en sortir	:LV
s’en soucier comme de l’an quarante	:LV
s’en soucier comme d’une guigne	:LV
s’en tamponner	:LV
s’en tamponner le coquillard	:LV
s’en taper	:LV
s’en tenir là	:LV
s’en tenir à la lettre	:LV
s’en tirer	:LVi
s’en tirer par la peau des dents	:LV
s’en vaseliner le coccyx	:LV
s’en venir	:LV
s’en voir	:LV
s’en être	:LVi
s’endormir du sommeil de la tombe	:LVi
s’endormir du sommeil du juste	:LV
s’endormir sur le manche	:LV
s’endormir sur le rôti	:LV
s’endormir sur ses lauriers	:LV
s’endormir sur ses lauriers	:LV
s’enfarger dans les fleurs du tapis	:LV
s’enfoncer dans le crâne	:LV
s’enfuir un pied chaussé et l’autre nu	:LV
s’enfuir un pied chaussé, l’autre nu	:LV
s’enivrer de fumée	:LVi
s’entendre comme chien et chat	:LV
s’entendre comme des larrons en foire	:LV
s’entendre comme larrons en foire	:LV
s’envoyer des fleurs	:LV
s’envoyer des noms d’oiseaux	:LV
s’envoyer en l’air	:LVp
s’essayer à	:LV
s’expliquer en gentlemen	:LV
s’habiller au décrochez-moi-ça	:LV
s’habiller en pelures d’oignon	:LVp
s’inscrire en faux	:LV
s’inscrire en faux	:LV
s’occuper de	:LVt
s’occuper de ses fesses	:LVp
s’occuper de ses oignons	:LV
s’occuper à	:LVt
s’offrir en spectacle	:LVi
s’te plait	:LV
s’te plaît	:LV
s’y casser les dents	:LV
s’y coller	:LV
s’y connaître	:LV
s’y croire	:LV
s’y mettre	:LVp
s’y prendre	:LVi
s’échauffer dans son harnois	:LVi
s’éclater comme des bêtes	:LV
s’énerver le poil des jambes	:LV
s’établir solidement	:LV
tailler dans le vif	:LV
tailler des croupières	:LVi
tailler en pièces	:LVt
tailler le bout de gras	:LV
tailler les crayons	:LV
tailler les oreilles en pointe	:LV
tailler un costard	:LV
tailler un costume	:LV
tailler un short	:LV
tailler une bavette	:LV
tailler une pipe	:LV
tailler une plume	:LV
taper dans la gourde	:LV
taper dans le nombril	:LV
taper dans le tas	:LV
taper dans l’œil	:LV
taper du pied	:LVi
taper du poing sur la table	:LV
taper la discut’	:LV
taper la mef	:LV
taper le carton	:LV
taper l’ignore	:LV
taper l’incruste	:LV
taper sur le système	:LV
taper sur les nerfs	:LVi
taper un bœuf	:LVip
taper à la machine	:LV
taquiner le goujon	:LVi
tendre la joue gauche	:LV
tendre la main	:LV
tendre la main à	:LV
tendre la perche	:LV
tendre le bâton pour se faire battre	:LV
tendre le cou	:LVi
tendre les bras	:LV
tendre l’autre joue	:LV
tendre l’oreille	:LVi
tendre une perche	:LVn
tenir au courant	:LV
tenir au cœur	:LV
tenir avec	:LV
tenir bon	:LVi
tenir chapelle	:LV
tenir chaud	:LV
tenir comme teigne	:LV
tenir comme à la prunelle de ses yeux	:LV
tenir compagnie	:LV
tenir compte	:LV
tenir dans sa main	:LV
tenir de court	:LV
tenir debout	:LV
tenir en bride	:LV
tenir en estime	:LV
tenir en haleine	:LV
tenir en joue	:LV
tenir en laisse	:LV
tenir en respect	:LVt
tenir en échec	:LVt
tenir ferme	:LVi
tenir garnison	:LV
tenir la banque	:LV
tenir la barre	:LV
tenir la bride courte	:LV
tenir la bride haute	:LVi
tenir la caisse	:LV
tenir la chandelle	:LV
tenir la corde	:LV
tenir la corne	:LV
tenir la dragée haute	:LV
tenir la jambe	:LV
tenir la main	:LV
tenir la main haute	:LVi
tenir la mer	:LV
tenir la plume	:LV
tenir la queue de la poêle	:LV
tenir la route	:LV
tenir la scène	:LV
tenir la vedette	:LVi
tenir le bec dans l’eau	:LV
tenir le bon bout	:LV
tenir le coup	:LV
tenir le crachoir	:LV
tenir le haut du pavé	:LV
tenir le loup par les oreilles	:LVi
tenir le milieu	:LV
tenir le rythme	:LV
tenir le travers	:LV
tenir le vent	:LV
tenir les cordons de la bourse	:LV
tenir les cordons du poêle	:LV
tenir les ficelles	:LV
tenir les pouces	:LV
tenir les rênes	:LV
tenir lieu	:LVi
tenir l’article	:LVi
tenir note	:LV
tenir parole	:LV
tenir pied à boule	:LV
tenir pour	:LVtp
tenir quitte	:LVt
tenir registre	:LV
tenir registre de tout	:LV
tenir rigueur	:LVn
tenir sa langue	:LV
tenir salon	:LV
tenir son rang	:LV
tenir sur la sellette	:LVt
tenir sur les fonts	:LVt
tenir tête	:LVi
tenir à carreau	:LVt
tenir à cœur	:LV
tenir à distance	:LV
tenir à honneur	:LV
tenir à jour	:LVt
tenir à la gorge	:LV
tenir à l’écart	:LV
tenir à l’œil	:LV
tenir à quatre	:LV
tenir à quelque chose comme à la prunelle de ses yeux	:LV
tenir à un fil	:LV
tenir école	:LV
tenter dieu	:LVi
tenter le coup	:LV
tenter le diable	:LV
tenter l’aventure	:LV
tirer au clair	:LVt
tirer au cul	:LV
tirer au flanc	:LV
tirer au jugé	:LVi
tirer au large	:LVi
tirer au renard	:LV
tirer au sort	:LV
tirer au vol	:LVt
tirer avantage	:LVi
tirer bénéfice	:LVn
tirer copie	:LVi
tirer dans le dos	:LV
tirer dans le tas	:LV
tirer de la boue	:LVt
tirer de la poussière	:LVi
tirer de l’argent	:LVi
tirer de l’huile d’un mur	:LVi
tirer des armes	:LV
tirer des bords	:LVi
tirer des bordées	:LVi
tirer des bras de la mort	:LV
tirer des larmes	:LVi
tirer des plans sur la comète	:LV
tirer des sons	:LVi
tirer deux moutures du même sac	:LVi
tirer du feu d’un caillou	:LVi
tirer du sang	:LVi
tirer d’un mauvais pas	:LVi
tirer d’un sac deux moutures	:LVi
tirer en longueur	:LVi
tirer juste	:LVi
tirer la chasse d’eau	:LVi
tirer la chaîne	:LV
tirer la copie	:LVi
tirer la couverture à soi	:LVi
tirer la gueule	:LV
tirer la jambe en arrière	:LVi
tirer la langue	:LVi
tirer la manche	:LV
tirer la pipe	:LV
tirer la plogue	:LVi
tirer la sonnette d’alarme	:LV
tirer la tronche	:LV
tirer la tête	:LV
tirer le bon numéro	:LV
tirer le cordon	:LV
tirer le diable par la queue	:LV
tirer le mauvais numéro	:LV
tirer le pied en arrière	:LVi
tirer le rideau	:LV
tirer le verrou	:LVi
tirer les cartes	:LV
tirer les ficelles	:LV
tirer les marrons du feu	:LV
tirer les oreilles	:LV
tirer les parties d’une partition	:LVi
tirer les rideaux	:LVi
tirer les rois	:LVi
tirer les vers du nez	:LVi
tirer les yeux	:LVi
tirer l’horoscope	:LVi
tirer l’oreille	:LV
tirer l’échelle	:LVi
tirer l’épée	:LVi
tirer l’épée contre son prince	:LVi
tirer parti	:LVi
tirer peine	:LV
tirer pied ou aile	:LVi
tirer pied ou aile de	:LV
tirer profit	:LV
tirer raison	:LVi
tirer sa crampe	:LV
tirer sa flemme	:LV
tirer sa poudre aux moineaux	:LVi
tirer sa révérence	:LVi
tirer sa source	:LVi
tirer satisfaction	:LVi
tirer ses chausses	:LVi
tirer ses grègues	:LVi
tirer son chapeau	:LV
tirer son coup	:LV
tirer son nom	:LVi
tirer son origine	:LVi
tirer son plan	:LVi
tirer son épingle du jeu	:LV
tirer sur la corde	:LV
tirer sur la ficelle	:LV
tirer sur le pianiste	:LV
tirer sur l’ambulance	:LV
tirer sur ses gens	:LVi
tirer sur ses troupes	:LVi
tirer un coup	:LV
tirer un trait	:LV
tirer un éclaircissement	:LVi
tirer une carotte	:LV
tirer une copie	:LVi
tirer une gueule	:LV
tirer une loterie	:LVi
tirer une pipe	:LV
tirer une épine du pied	:LVi
tirer vanité	:LVi
tirer vengeance	:LVi
tirer à boulet rouge	:LV
tirer à boulets rouges	:LV
tirer à conséquence	:LVi
tirer à coup perdu	:LV
tirer à hue et à dia	:LV
tirer à la courte paille	:LVt
tirer à la ligne	:LVi
tirer à la main	:LVi
tirer à l’oiseau	:LVi
tirer à l’écart	:LVi
tirer à sa fin	:LVi
tirer à vue	:LV
tomber amoureux	:LV
tomber aux mains	:LV
tomber aux oubliettes	:LV
tomber aux pieds de	:LV
tomber comme capucins de carte	:LVi
tomber comme capucins de cartes	:LVi
tomber comme des mouches	:LV
tomber comme un couperet	:LV
tomber comme un fruit mûr	:LV
tomber comme une bombe	:LV
tomber comme à gravelotte	:LV
tomber dans la caricature	:LV
tomber dans la marmite	:LV
tomber dans le lac	:LV
tomber dans le panneau	:LV
tomber dans le piège	:LVi
tomber dans les bras de morphée	:LVi
tomber dans les filets de quelqu’un	:LV
tomber dans les pommes	:LV
tomber dans l’oreille d’un sourd	:LV
tomber dans l’oubli	:LV
tomber dans l’œil	:LV
tomber de charybde en scylla	:LV
tomber de haut	:LV
tomber de la lune	:LV
tomber de son haut	:LVi
tomber des cordes	:LV
tomber des mains	:LV
tomber des nues	:LVi
tomber du ciel	:LV
tomber du lit	:LV
tomber d’accord	:LVn
tomber d’un excès dans l’autre	:LV
tomber en amour	:LV
tomber en désuétude	:LVi
tomber en frime	:LV
tomber en panne	:LV
tomber en poussière	:LV
tomber en quenouille	:LV
tomber en rideau	:LV
tomber en ruine	:LVi
tomber enceinte	:LV
tomber juste	:LV
tomber la tête la première	:LVi
tomber la veste	:LVi
tomber mal	:LV
tomber malade	:LVi
tomber pile	:LV
tomber sous la main	:LV
tomber sous la table	:LV
tomber sous le sens	:LV
tomber sous le vent	:LVi
tomber sur le coin de la gueule	:LV
tomber sur le dos	:LV
tomber sur le paletot	:LV
tomber sur un bec	:LVi
tomber sur un manche	:LV
tomber sur un os	:LVi
tomber tout cuit dans le bec	:LV
tomber à bras raccourcis	:LV
tomber à la renverse	:LV
tomber à l’eau	:LV
tomber à pic	:LV
tomber à plat	:LV
tordre le bras	:LVi
tordre le cou	:LV
tordre le nez	:LV
toucher barre	:LVi
toucher dans la main	:LV
toucher de la peau de singe	:LV
toucher deux mots	:LV
toucher du bois	:LV
toucher du doigt	:LV
toucher du doigt la solution	:LV
toucher la corde sensible	:LV
toucher le fond	:LV
toucher le jackpot	:LV
toucher mot de	:LV
toucher sa bille	:LV
toucher son caramel	:LV
toucher terre	:LV
toucher un mot	:LV
toujours courir	:LV
tourner au vinaigre	:LV
tourner autour	:LV
tourner autour du pot	:LV
tourner bride	:LV
tourner casaque	:LV
tourner comme un lion en cage	:LVi
tourner comme un écureuil en cage	:LV
tourner comme une girouette	:LV
tourner court	:LV
tourner de l’œil	:LV
tourner en dérision	:LV
tourner en eau de boudin	:LV
tourner en ridicule	:LV
tourner en rond	:LV
tourner la carte	:LV
tourner la page	:LV
tourner la tête à	:LV
tourner le dos	:LVi
tourner le dos à	:LV
tourner le fer dans la plaie	:LV
tourner les coins ronds	:LV
tourner les talons	:LVi
tourner rond	:LV
tourner sa langue sept fois dans sa bouche	:LV
tourner sa langue sept fois dans sa bouche avant de se taire	:LV
tourner sept fois ses doigts au-dessus de son clavier	:LV
tourner sur trois pattes	:LV
tourner à l’aigre	:LV
tourner à tout vent	:LVi
tourner à vide	:LV
tracer la route	:LV
traduire à coups de dictionnaire	:LV
trainer des casseroles	:LV
trainer une casserole	:LV
traiter au sulfate de mépris	:LV
traiter comme un chien	:LV
traiter de tous les noms	:LV
traiter de tous les noms (d’oiseaux)	:LV
traiter en quantité négligeable	:LV
traiter par dessous la jambe	:LVt
traiter par dessus la jambe	:LVt
traiter quelqu’un de turc à maure	:LV:e
trancher dans le vif	:LV
trancher le mot	:LV
transformer en passoire	:LVt
transmettre le flambeau	:LV
transporter ses pénates	:LV
travailler au corps	:LV
travailler au noir	:LV
travailler comme un nègre	:LV
travailler du chapeau	:LV
travailler pour le roi de prusse	:LV
travailler à	:LV
traverser une voiture	:LV
traîner (comme) un boulet	:LV
traîner aux gémonies	:LV
traîner dans la boue	:LVt
traîner le boulet	:LV
traîner ses guêtres	:LVt
traîner une casserole	:LV
trembler comme des feuilles	:LV:p
trembler comme la feuille	:LV
trembler comme une feuille	:LV:s
trembler le grelot	:LV
tremper de l’acier	:LV
tremper sa nouille	:LV
tremper sa plume dans le vitriol	:LV
tremper son biscuit	:LV
trier sur le volet	:LVt
trotter dans la tête	:LVi
trotter menu	:LVi
trotter par la tête	:LVi
troubler la fête	:LVi
trouer le cul	:LVtp
trouver bon	:LVi
trouver buisson creux	:LV
trouver chaussure à son pied	:LVi
trouver des pierres dans son chemin	:LV
trouver grâce	:LV
trouver la mort	:LVi
trouver le chemin des filets	:LV
trouver le filon	:LV
trouver le mot de l’énigme	:LVi
trouver le temps	:LV
trouver le temps long	:LVi
trouver mauvais	:LVi
trouver place	:LV
trouver son compte	:LVi
trouver son maître	:LVi
trouver sur son chemin	:LVi
trouver visage de bois	:LV
trouver à dire	:LVi
trouver à qui parler	:LVi
trouver à redire	:LVi
tuer dans l’oeuf	:LV
tuer dans l’œuf	:LV
tuer la poule aux œufs d’or	:LV
tuer la poule pour avoir l’œuf	:LVi
tuer le courrier	:LV
tuer le mandarin	:LV
tuer le messager	:LV
tuer le père	:LV
tuer le temps	:LV
tuer le ver	:LV
tuer par balle	:LV
tuer une mouche avec un canon	:LV
tuer une tache	:LV
tutoyer le flacon	:LV
tutoyer le pontife	:LV
tâcher moyen	:LVi
tâter le pouls	:LV
tâter le terrain	:LV
téléphoner aux congolais	:LV
user et abuser	:LV
user ses fonds de culotte sur les bancs de l’école	:LV
valoir comme un sou	:LVt
valoir de l’argent	:LVi
valoir le coup	:LV
valoir mieux	:LVi
valoir son pesant de cacahuètes	:LV
valoir son pesant d’or	:LVi
vaquer à	:LVi
veiller au grain	:LV
veiller les morts	:LV
vendre chat en poche	:LV
vendre du rêve	:LV
vendre la mèche	:LV
vendre la peau de l’ours	:LV
vendre la peau de l’ours avant de l’avoir tué	:LV
vendre père et mère	:LV
vendre sa salade	:LV
vendre son âme au diable	:LV
venir au fait	:LV
venir au jour	:LV
venir au monde	:LVi
venir aux oreilles	:LVi
venir de	:LV
venir de son pied	:LV
venir dire des grâces	:LVi
venir dire grâce	:LVi
venir dire grâces	:LVi
venir du froid	:LV
venir en aide	:LVn
venir sur le tapis	:LVi
venir à bout	:LV
venir à canossa	:LVi
venir à la rencontre	:LV
venir à l’esprit	:LV
venir à l’oreille de quelqu’un	:LV
venir à résipiscence	:LV
venter à écorner les bœufs	:LVim
verser des larmes de crocodile	:LV
vider de sa substance	:LV
vider l’abcès	:LV
vider ses couilles	:LV
vider son carquois	:LV
vider son sac	:LV
viendez ma bande	:LV:i
violer la loi	:LV
virer dans le beurre	:LV
virer de bord	:LVi
virer en basse-messe	:LV
virer sa cuti	:LV
virer une brosse	:LV
visser sa plaque	:LV
vivre au jour la journée	:LVi
vivre au jour le jour	:LVi
vivre aux crochets de	:LV
vivre avec soi-même	:LVi
vivre avec son temps	:LV
vivre comme un loup	:LV
vivre dans un autre monde	:LV
vivre dans une grotte	:LV
vivre de l’air du temps	:LVi
vivre de régime	:LVi
vivre de sa plume	:LV
vivre de sa réputation	:LVi
vivre de ses bras	:LV
vivre d’amour et d’eau fraiche	:LV
vivre d’amour et d’eau fraîche	:LV
vivre d’espérance	:LVi
vivre les pieds sur les chenets	:LV
vivre noblement	:LVi
vivre sur sa réputation	:LVi
vivre sur un grand pied	:LV
vivre à bon marché	:LV
vivre à la même table	:LV
voir arriver avec ses gros sabots	:LV
voir bien loin	:LV
voir de bon œil	:LV
voir de haut	:LVi
voir de loin	:LV
voir de mauvais œil	:LV
voir de quel côté vient le vent	:LVi
voir des éléphants roses	:LV
voir des étoiles	:LV
voir double	:LV
voir d’un bon œil	:LV
voir d’un mauvais œil	:LV
voir grand	:LV
voir la feuille à l’envers	:LV
voir la lune en plein jour	:LV
voir la mort de près	:LV
voir la vie en rose	:LV
voir la vierge	:LV
voir le bout du tunnel	:LV
voir le jour	:LVi
voir le loup	:LV
voir les choses en grand	:LV
voir les choses en noir	:LV
voir loin	:LV
voir midi à sa porte	:LV
voir rouge	:LV
voir ses juges	:LV
voir tout en rose	:LV
voir trente six chandelles	:LV
voir trente-six chandelles	:LV
voir venir	:LV
voir à l’usure	:LV
voler au vent	:LVi
voler de ses propres ailes	:LV
voler en éclats	:LVi
voler la vedette	:LV
voler à l’étalage	:LV
vomir son venin	:LV
vomir tripes et boyaux	:LVi
vouer au bleu	:LV
vouer aux gémonies	:LV
vouloir bien	:LV
vouloir dire	:LVt
vouloir la tête	:LV
vouloir le beurre et l’argent du beurre	:LV
vouloir une médaille	:LVi
voyager léger	:LV
y aller comme une corneille qui abat des noix	:LV
y aller de sa tête	:LVi
y aller du cigare	:LV
y aller fort	:LV
y aller mollo	:LV
y avoir anguille sous roche	:LV
y avoir baleine sous graviers	:LV
y avoir caca sous neige	:LV
y avoir de l’eau dans le gaz	:LV
y avoir de l’électricité dans l’air	:LV
y avoir de quoi s’arracher les cheveux	:LV
y avoir du monde au balcon	:LV
y avoir péril en la demeure	:LV
y avoir quelque chose qui cloche	:LV
y avoir un loup	:LV
y avoir une cenne à faire	:LV
y avoir une couille dans le potage	:LV
y avoir une couille dans le pâté	:LV
y avoir une piastre à faire	:LV
y laisser des plumes	:LV
y mettre de la conscience	:LVi
y regarder à deux fois	:LV
yoyoter de la touffe	:LV
zigzaguer entre les verres	:LV
écarter les cuisses	:LVi
échapper du	:LVi
échauffer les oreilles	:LVn
éclairer la lanterne de	:LV
éclairer sa lanterne	:LV
éclater de rire	:LV
écorcher la langue	:LVt
écorcher les oreilles	:LV
écouter aux portes	:LV
écouter de toutes ses oreilles	:LVi
écouter d’une oreille	:LV
écraser comme un ver	:LVt
écraser une mouche avec un marteau	:LV
écrire au courant de la plume	:LV
écrire comme un chat	:LV
écrire comme un cochon	:LV
écrire comme un porc	:LV
écrire en lettres d’or	:LV
élever au carré	:LV
élever au cube	:LV
élever au pinacle	:LV
élever autel contre autel	:LVi
élever la voix	:LV
élever le ton	:LV
élever à la puissance	:LV
épargner sa peine	:LV
épater la galerie	:LV
éplucher des vieux légumes	:LV
épouser de la main gauche	:LVt
étouffer dans l’oeuf	:LV
étouffer dans l’œuf	:LV
étourdir les oreilles	:LV
étrangler le borgne	:LV
éveiller le chat qui dort	:LV
éventer la mèche	:LV
être ailleurs	:LV
être après	:LV
être assis entre deux chaises	:LV
être au 36e dessous	:LV
être au bout de son latin	:LV
être au bout de son rouleau	:LV
être au ciel	:LV
être au coin	:LV
être au courant	:LV
être au diapason	:LV
être au désespoir	:LV
être au fond du trou	:LV
être au four et au moulin	:LV
être au pain et à l’eau	:LV
être au parfum	:LV
être au pied du mur	:LV
être au radar	:LV
être au septième ciel	:LV
être au supplice	:LV
être au taquet	:LV
être au top	:LV
être au vent	:LV
être au volant	:LV
être aux anges	:LV
être aux cent coups	:LV
être aux hommes	:LV
être aux manettes	:LVi
être aux oiseaux	:LV
être aux petits soins	:LV
être aux petits soins pour	:LV
être aux pièces	:LVi
être aux premières loges	:LV
être aux prises	:LV
être avec son jeune homme	:LVi
être bien dans ses baskets	:LV
être bien en selle	:LV
être bien endenté	:LV
être bien loti	:LV
être bien vu	:LV
être blanc comme un navet	:LV
être bon à jeter aux chiens	:LV
être boutonné en jaloux	:LV
être bête à manger du foin	:LV
être casquette	:LV:i
être charrette	:LV
être chiche	:LV
être chié	:LV
être chocolat	:LVi
être clair comme de l’eau de roche	:LV
être cloué au lit	:LV
être coiffé avec les pattes du réveil	:LVi
être coiffé comme la poupée du diable	:LV
être coiffé comme un dessous de bras	:LV
être coiffé de	:LV
être coincé	:LV
être comme rat en paille	:LV
être comme saint thomas	:LVi
être comme un poisson dans l’eau	:LV
être comme une pierre dans un mur	:LV
être comme une poule qui a couvé des œufs de cane	:LVi
être copains comme cochons	:LV
être couillu	:LV
être cramponné à	:LV
être culotté	:LV
être dans de beaux draps	:LVi
être dans de sales draps	:LVi
être dans la course	:LV
être dans la dèche	:LV
être dans la lune	:LV
être dans la marde	:LV
être dans la merde	:LV
être dans la mouise	:LV
être dans la note	:LV
être dans la panade	:LV
être dans la peau de	:LV
être dans le bleu	:LV
être dans le champ	:LV
être dans le coaltar	:LV
être dans le gaz	:LV
être dans le jus	:LV
être dans le mal	:LV
être dans le mouvement	:LV
être dans le même bateau	:LV
être dans le noir	:LV
être dans le pâté	:LV
être dans le pétrin	:LV
être dans le rouge	:LV
être dans le secret des dieux	:LV
être dans le ton	:LV
être dans le vert	:LV
être dans les bras de morphée	:LVi
être dans les brouillards du rhône	:LV
être dans les choux	:LV
être dans les clous	:LV
être dans les nuages	:LV
être dans les patates	:LV
être dans les petits papiers de	:LV
être dans les pommes	:LV
être dans les starting blocks	:LV
être dans l’abandon	:LV
être dans l’air	:LV
être dans l’œil du cyclone	:LV
être dans sa poche	:LV
être dans ses petits souliers	:LV
être dans ses prix	:LV
être dans son assiette	:LV
être dans son élément	:LV
être dans un bon jour	:LV
être dans un mauvais jour	:LV
être de	:LV
être de bon augure	:LV
être de bon poil	:LV
être de force à	:LV
être de glace	:LV
être de la confrérie du pot au lait	:LV
être de la fanfare	:LV
être de la jaquette	:LV
être de la tarte	:LV
être de marbre	:LVi
être de mariage	:LV
être de mauvais augure	:LV
être de montauban	:LV
être de mèche	:LV
être de mèche avec	:LV
être de notoriété publique	:LV
être de revoyure	:LV
être de taille à	:LV
être de tout cœur	:LV
être debout	:LV
être dedans	:LV
être digne de foi	:LV
être donnant donnant	:LV
être dos au mur	:LV
être doux comme un agneau	:LV
être droit comme un jonc	:LV
être du bois dont on fait les grands hommes	:LV
être du bâtiment	:LV
être du chinois	:LV
être du dernier bien	:LVn
être du dernier mieux	:LV
être du même bord	:LV
être du pain bien dur à manger	:LV
être dupe	:LVn
être dur de comprenure	:LV
être dur d’oreille	:LV
être déferré des quatre pieds	:LV
être dévot à	:LV
être d’accord	:LV
être d’attaque	:LVi
être d’enterrement	:LV
être en action	:LV
être en amour	:LV
être en bons termes	:LV
être en butte	:LV
être en caisse	:LV
être en caleçon	:LV
être en chair	:LV
être en cloque	:LV
être en couches	:LV
être en couple	:LV
être en croix	:LV
être en droit de	:LV
être en défaut	:LV
être en dérive	:LVi
être en fonds	:LVi
être en forme	:LV
être en froid avec	:LV
être en fusil	:LV
être en grâce	:LVn
être en haleine	:LV
être en honneur	:LVi
être en jeu	:LV
être en mesure de	:LV
être en mouvement	:LV
être en nage	:LV
être en pays de connaissance	:LV
être en perte de vitesse	:LV
être en pied	:LVi
être en pingouin	:LV
être en piste	:LV
être en pleine forme	:LVi
être en pls	:LV
être en porte-à-faux	:LV
être en proie à	:LV
être en pétard	:LV
être en reste avec	:LV
être en train de	:LV
être en veine	:LV
être en vie	:LVi
être en voie de	:LVt
être en voix	:LV
être en éveil	:LV
être en évidence	:LV
être encore sur ses pieds	:LVi
être enfoncé dans la matière	:LVi
être enluminé	:LV
être enrhumé comme un loup	:LV
être entre gaillac et rabastens	:LV
être entre le marteau et l’enclume	:LV
être fait	:LV
être fait (comme un rat)	:LV
être fait comme les haricots	:LV
être fait comme un rat	:LV
être fait pour	:LV
être faux comme un jeton	:LV
être femme de conscience	:LV
être fermé dehors	:LV
être fini	:LV
être fini à la pisse	:LV
être fort en gueule	:LV
être fou de	:LV
être game	:LV
être gros de	:LV
être gros-jean comme devant	:LV
être grosse	:LVi
être habillé comme la chienne à jacques	:LV
être habillé à l’as de pique	:LV
être homme de conscience	:LV
être juge et partie	:LV
être la fête	:LVn
être la honte de	:LV
être le bec dans l’eau	:LV
être le cas	:LV
être le dos au mur	:LV
être le grain de sable dans la mécanique	:LV
être le pied	:LV
être logé à la même enseigne	:LV
être longtemps	:LV
être là comme rats en paille	:LV
être là pour décorer	:LVi
être légère de la cuisse	:LV
être l’ombre de	:LV
être l’ombre de soi-même	:LV
être mal loti	:LV
être mal vu	:LV
être marron	:LV
être maître de	:LV:m
être messé	:LVi
être mindé	:LV
être motorisé	:LV
être mou de la bite	:LV
être noir	:LV
être né avec une cuillère d’argent dans la bouche	:LV
être né un dimanche	:LV
être pendu au téléphone	:LV
être pendu aux lèvres de	:LV
être piqué par une mouche	:LV
être plié en quatre	:LV
être plus catholique que le pape	:LV
être plus royaliste que le roi	:LV
être porté sur	:LVt
être porté sur la chose	:LV
être porté à	:LVt
être preneur	:LV
être pris dans la mélasse	:LVi
être pris entre deux feux	:LV
être pris à la gorge	:LV
être pédé comme un phoque	:LV
être question	:LVm
être quitte	:LV
être rangé des voitures	:LV
être réglé comme du papier à musique	:LV
être sans issue	:LV
être sans le sou	:LV
être sans sou ni maille	:LV
être seul maitre à bord	:LV
être seul maître à bord	:LV
être soumis à la question	:LV
être sourd	:LV
être sous la férule de	:LV
être sous la table	:LV
être sous les projecteurs	:LV
être sur la bonne route	:LV
être sur la brèche	:LV
être sur la corde raide	:LV
être sur la mauvaise pente	:LV
être sur la même longueur d’onde	:LV
être sur la paille	:LV
être sur la sellette	:LV
être sur la touche	:LV
être sur le bord de l’abîme	:LV
être sur le bord de sa fosse	:LVi
être sur le bureau	:LV
être sur le carreau	:LV
être sur le fil du rasoir	:LV
être sur le flanc	:LV
être sur le gros nerf	:LV
être sur le marché	:LV
être sur le point de	:LV
être sur le retour	:LV
être sur le sentier de la guerre	:LV
être sur les dents	:LV
être sur les nerfs	:LV
être sur les rangs	:LV
être sur les rotules	:LV
être sur les talons	:LV
être sur pied	:LVt
être sur son départ	:LVi
être sur son terrain	:LV
être sur son trente et un	:LV
être sur son trente-et-un	:LV
être sur terre	:LVi
être sur un grand pied	:LVi
être sur une mauvaise pente	:LV
être sur une pente glissante	:LV
être sur écoute	:LV
être sûr de son coup	:LV
être sûr de son fait	:LV
être temps	:LV
être tenu de	:LV
être tenu à	:LV
être tiguidou	:LVm
être tiré à quatre épingles	:LV
être tombé sur la tête	:LVi
être toqué de	:LVt
être touché au vif	:LV
être toujours pendu aux oreilles de quelqu’un	:LV
être tout cœur	:LV
être tout geht’s	:LVi
être tout je ne sais comment	:LVi
être tout miel	:LV
être tout oreilles	:LV
être tout sucre	:LV
être tout vu	:LV
être tout yeux	:LV
être trempé jusqu’aux os	:LV
être trop	:LV
être trop d’une bonne chose	:LVi
être un brave à trois poils	:LV
être un homme mort	:LV
être un oiseau pour le chat	:LVt
être une bille	:LV
être une sainte nitouche	:LV
être verni	:LV
être vert	:LV
être vert de rage	:LV
être vite sur le piton	:LV
être wanted	:LV
être à cent lieues	:LVi
être à chancy	:LV
être à charge	:LV
être à cheval sur	:LV
être à cheval sur les principes	:LV
être à cran	:LV
être à côté de la plaque	:LV
être à deux doigts	:LV
être à deux doigts de	:LV
être à découvert	:LV
être à fond de cale	:LV
être à la bande	:LV
être à la barre	:LV
être à la botte	:LV
être à la bourre	:LV
être à la cape	:LVi
être à la dernière cenne	:LV
être à la hauteur	:LV
être à la masse	:LV
être à la mort	:LV
être à la page	:LV
être à la peine	:LV
être à la pointe	:LV
être à la ramasse	:LV
être à la recherche	:LV
être à la rue	:LV
être à la traîne	:LV
être à l’affut	:LV
être à l’eau	:LV
être à l’heure	:LVi
être à l’os	:LV
être à l’ouest	:LV
être à l’œuvre	:LV
être à mille lieues	:LVi
être à même de	:LVi
être à peu près temps	:LV
être à plat	:LV
être à prendre avec des pincettes	:LV
être à ramasser à la petite cuiller	:LV
être à ramasser à la petite cuillère	:LV
être à sec	:LV
être à table	:LV
être à tu et à toi	:LV
être à voile et à vapeur	:LVi
être âpre à la curée	:LV
être étourdi comme le premier coup de matines	:LV
ôter de la tête	:LV
ôter de l’esprit	:LV
ôter le fil	:LV
ôter le pain de la bouche	:LVt
