# Locutions adjectivales

a frigore	:LA
a silentio	:LA:i
à ban	:LA:e:i
à base dénombrable	:LA:i
à bord	:LA
à bout de force	:LA:i
à bout de forces	:LA:i
à bout de nerfs	:LA
à bout de patience	:LA
à côté de ses pompes	:LA
à cheval	:LA
à cinq cennes	:LA
à cinq cennes et quart	:LA
à claire-voie	:LA:f
à coucher dehors	:LA
à couper au couteau	:LA
à couper le souffle	:LA
à croquer	:LA
à deux balles	:LA
à deux vitesses	:LA
à distance de sécurité	:LA
à documentation intégrée	:LA
à donner de la tête contre les murs	:LA
à dormir debout	:LA:i
à double entente	:LA:e:i
à double tranchant	:LA:i
à façon	:LA
à faire peur	:LA:i
à gages	:LA:i
à jour	:LA
à la clamart	:LA
à la clamartoise	:LA
à la con	:LA:i
à la condé	:LA:e
à la coque	:LA
à la coule	:LA
à la criée	:LA
à la diable	:LA:m
à la dieppoise	:LA
à la dijonnaise	:LA
à la feuille d’or	:LA:e
à la française	:LA:i
à la gâchette facile	:LA
à la glace	:LA:i
à la grecque	:LA
à la main lourde	:LA
à la manque	:LA
à la mord-moi-le-nœud	:LA:i
à la mords-moi	:LA:i
à la mords-moi-l’nœud	:LA:e:i
à la mords-moi-le-nœud	:LA:e:i
à la ninon	:LA:i
à la noix	:LA:i
à la noix de coco	:LA:e:i
à la page	:LA
à la portée de toutes les bourses	:LA
à la pouche	:LA:i
à la poulette	:LA:e:i
à la redresse	:LA:e:i
à la roule-moi les couilles dans la laitue	:LA:e:i
à la roxelane	:LA
à la sainte-ménehould	:LA
à la solde	:LA
à la suite	:LA
à lège	:LA
à l’étouffée	:LA:i
à l’allemande	:LA:i
à l’ancre	:LA
à l’berdouille	:LA
à l’eau de rose	:LA
à l’escarbouillette	:LA:e:i
à l’index	:LA
à l’italienne	:LA:i
à loilpé	:LA:i
à ma portée	:LA
à même de	:LA
à marquer d’une pierre blanche	:LA
à moitié nu	:LA:m:s
à moitié nus	:LA:m:p
à mourir de rire	:LA
à neuf	:LA
à oualp	:LA
à oualpé	:LA:m
à parité	:LA
à part entière	:LA
à poil	:LA:i
à poste	:LA
à prendre ou à laisser	:LA:i
à qui on ne la fait pas	:LA:e
à quia	:LA/L
à sa main	:LA
à s’en relever la nuit	:LA
à sang chaud	:LA:i
à sang froid	:LA:i
à se coincer les parties dans une porte	:LA:i
à se relever la nuit	:LA
à se taper le cul par terre	:LA
à sec de toile	:LA
à suivre	:LA:i
à support compact	:LA
à tête perdue	:LA:e:i
à toute épreuve	:LA
à toutes mains	:LA
à tu et à toi	:LA
à vérif.	:LA
à valeurs positives	:LA
à venir	:LA
à voile et à vapeur	:LA
à vomir	:LA:i
à walpé	:LA
économiquement faible	:LA:s
économiquement faibles	:LA:p
écroulé de rire	:LA:m:s
éfaté du sud	:LA:m|:LN:m
épais dans le plus mince	:LA
état limite	:LA:e:s|:LN:m:s
états limites	:LA:e:p|:LN:m:p
étroit d’esprit	:LA:m:s
étroits d’esprit	:LA:m:p
îlot directionnel	:LA
aéro-anaérobie facultatif	:LA:s
aéro-anaérobies facultatifs	:LA:p
abénaki de l’est	:LA:m|:LN:m
abai sembuak	:LA:m|:LN:m
abai tubu	:LA:m|:LN:m
acide margarino-sulfurique	:LA
ad hoc	:LA:i/L
ad hominem	:LA:i/L
ad usum delphini	:LA/L
ad valorem	:LA/L
agathien christien	:LA:m:s
agité du bocal	:LA:m|:LN:m:s
aigre comme verjus	:LA:s
aigres comme verjus	:LA:p
aimable comme une porte de prison	:LA:s
aimables comme une porte de prison	:LA:p
all dressed	:LA:e
amis comme cochons	:LA:m:i:p
ante mortem	:LA/L|:LN:m/L
anti-jambe lourde	:LA
anti-jambes lourdes	:LA
anti poussière	:LA:s
anti poussières	:LA:p
ap. j.-c.	:LA:i
apache de l’ouest	:LA:e|:LN:m:i:s
apache des plaines	:LA:e|:LN:m:i:s
apr. j.-c.	:LA:i
après j.-c.	:LA:i
après jésus-christ	:LA:i
armé comme un porte-avion	:LA:m:s
armé comme un porte-avions	:LA:m:s
armé jusqu’aux dents	:LA:m:s
armés jusqu’aux dents	:LA:m:p
atome creux	:LA:m:s
atomes creux	:LA:m:p
au-dessus de tout soupçon	:LA
au bord de la crise	:LA
au bout du rouleau	:LA
au courant	:LA:i
au goût du jour	:LA:i
au gout du jour	:LA:i
au grand jour	:LA
au napalm	:LA:i
au pied du mur	:LA:i
au plus dénombrable	:LA:e:s
au plus dénombrables	:LA:e:p
au point	:LA:i
au sucre	:LA
au vent	:LA:i
aux abois	:LA
aux abonnés absents	:LA
aux aguets	:LA:i
aux anges	:LA
aux doigts de rose	:LA:f
av. j.-c.	:LA:i
avant j.-c.	:LA:i
avant j.c.	:LA
avant jésus-christ	:LA:i
avant la lettre	:LA
avant l’ère commune	:LA:i
avant le présent	:LA
bâti à chaux et à sable	:LA:m:s
bâtis à chaux et à sable	:LA:m:p
bête à manger du foin	:LA
bête à pleurer	:LA
bête comme chou	:LA
bête comme ses pieds	:LA:e:s
bête comme un chou	:LA
bête comme un cochon	:LA:e:s
bête comme un pot	:LA
bêtes comme leurs pieds	:LA:e:p
bêtes comme un cochon	:LA:e:p
baba cool	:LA:e:s|:LN:e:s
babas cools	:LA:e:p|:LN:e:p
baniwa de l’içana	:LA:e|:LN:m
baram kayan	:LA:m:s|:LN:m
baram kayans	:LA:m:p
bas de plafond	:LA|:LN
bas du front	:LA
bas tanana	:LA:m:s|:LN:m
bas tananas	:LA:m:p
batak toba	:LA:m:s|:LN:m
batak tobas	:LA:m:p
battu de l’oiseau	:LA:m:s
batu belah	:LA:m|:LN:m
bavard comme une pie	:LA:m:s
beau comme le prince de galles	:LA
beau comme un camion	:LA:m:s
beau comme un dieu	:LA
beau cul belle gueule	:LA
berawan long jegan	:LA:m|:LN:m
berawan long terawan	:LA:m|:LN:m
bercé trop près du mur	:LA
bien à la main	:LA:i
bien élevé	:LA:m:s
bien aise	:LA:e:s
bien aises	:LA:e:p
bien astré	:LA:m:s
bien astrés	:LA:m:p
bien bâti	:LA:m:s
bien bâtis	:LA:m:p
bien coiffé	:LA
bien comme il faut	:LA
bien cuit	:LA
bien en chair	:LA:i|:LN:m:s
bien en main	:LA:i
bien faits	:LA:m:p
bien fatigué	:LA
bien formé	:LA:m:s
bien formés	:LA:m:p
bien membré	:LA:s
bien membrés	:LA:p
bien mis	:LA
bien monté	:LA:m:s
bien montés	:LA:m:p
bien né	:LA:m:s
bien ordonné	:LA:m:s
bien ordonnés	:LA:m:p
bien portant	:LA:m:s|:LN:m:s
bien portants	:LA:m:p|:LN:m:p
bien venu	:LA:m:s|:LN:m:s
bique et bouc	:LA
bit à bit	:LA
blanc bleu	:LA
blanc cassé	:LA:i|:LN:m
blanc comme neige	:LA:m:s
blanc comme un cachet d’aspirine	:LA:m:s
blanc comme un cygne	:LA:m:s
blanc comme un linge	:LA:m:s
blanc de peur	:LA:m:s
blancs comme des cachets d’aspirine	:LA:m:p
blancs comme des linges	:LA:m:p
blancs comme neige	:LA:m:p
bleu acier	:LA|:LN:m
bleu aldégo	:LA|:LN:m
bleu cæruleum	:LA:m:s|:LN:m:s
bleu céleste	:LA:m:s|:LN:m:s
bleu canard	:LA|:LN:m
bleu charrette	:LA:m:i|:LN:m:s
bleu charron	:LA:m:i|:LN:m:s
bleu ciel	:LA:i|:LN:m:i
bleu de france	:LA:m:i|:LN:m:p
bleu de prusse	:LA:m:i|:LN:m
bleu france	:LA:m:i|:LN:m
bleu horizon	:LA:m|:LN:m
bleu marine	:LA|:LN:m
bleu merle	:LA:m
bleu roi	:LA|:LN:m
bleu turquoise	:LA:i|:LN:m:i
bleus cæruleum	:LA:m:p|:LN:m:p
bleus célestes	:LA:m:p|:LN:m:p
blindé de tunes	:LA:m:s
blond ardent	:LA:i|:LN:m:i
blond cendré	:LA:i|:LN:m:i
blond d’or	:LA:i|:LN:m:i
blond de filasse	:LA:i|:LN:m:i
blond doré	:LA:i|:LN:m:i
blond filasse	:LA:i|:LN:m:i
blond vénitien	:LA:i|:LN:s
bois pelard	:LA:m:s
bois pelards	:LA:m:p
bon à	:LA
bon à rien	:LA:m:s|:LN:m:s
bon à rien, mauvais à tout	:LA:m:s|:LN:m:s
bon à tirer	:LA:m:s|:LN:m:s
bon chic bon genre	:LA:i|:LN:i
bon comme du bon pain	:LA:m:s
bon comme le bon pain	:LA:m:s
bon dieu de	:LA:i
bon enfant	:LA:i
bon marché	:LA:e:i|:LN:m
bon prince	:LA:s
bon public	:LA:i
bon teint	:LA:i
bonne femme	:LA|:LN:f
bonne poire	:LA:e:s|:LN:f:s
bonne pomme	:LA:i
bonnes poires	:LA:e:p|:LN:f:p
bonnet blanc, blanc bonnet	:LA:m:i:p
bons à rien	:LA:m:p|:LN:m:p
bons à rien, mauvais à tout	:LA:m:p|:LN:m:p
bons à tirer	:LA:m:p|:LN:m:p
bons princes	:LA:p
bord à quai	:LA
bouché à l’émeri	:LA:m:s
bouchés à l’émeri	:LA:m:p
bouche béante	:LA
bouffeur de curés	:LA:m:s|:LN:m:s
bouffeurs de curés	:LA:m:p|:LN:m:p
bourg d’iréens	:LA:m:p
bourré comme un coin	:LA:m:s
bourré comme un coing	:LA:m:s
broussyats p’tits	:LA:m:p
brut de décoffrage	:LA:m:s
brut de fonderie	:LA:m
bruts de décoffrage	:LA:m:p
buy to win	:LA:i
c’est celui qui dit qui l’est	:LA:m
caca d’oie	:LA:e:i
café au lait	:LA:e:i|:LN:m:s
camarades comme cochons	:LA:m:i:p
cas limite	:LA:e:s|:LN:m:s
cas limites	:LA:e:p|:LN:m:p
chambre antérieure	:LA:e
chaud bouillant	:LA
chaud bulex	:LA:m
chaud comme la braise	:LA:m:s
chaud comme une baraque à frites	:LA
chaude comme une baraque à frites	:LA:f
cheke holo	:LA:m:s|:LN:m
cheke holos	:LA:m:p
chiant comme la lune	:LA:m
chiant comme la pluie	:LA:m:s
chimique organique	:LA:e:s
chimiques organiques	:LA:e:p
chou vert et vert chou	:LA
clé en main	:LA:s
clés en main	:LA:p
clair comme de l’eau de roche	:LA:m:s
clair comme deux et deux font quatre	:LA:i
clair comme du jus de boudin	:LA:m:s
clair comme le jour	:LA:m:s
clair et apert	:LA:m:s
clair et appert	:LA:m:s
clair et manifeste	:LA:m:s
clairs comme de l’eau de roche	:LA:m:p
clairs comme du jus de boudin	:LA:m:p
clairs et aperts	:LA:m:p
clairs et apperts	:LA:m:p
classe de principes	:LA:m:s
classes de principes	:LA:m:p
coincé du cul	:LA
collet monté	:LA|:LN:s
comme cul et chemise	:LA
comme de cire	:LA:i
comme des pets sur une plaque de verglas	:LA:p
comme des pets sur une toile cirée	:LA:p
comme des poissons dans l’eau	:LA:p
comme des sous neufs	:LA:e:p
comme deux doigts de la main	:LA
comme les deux doigts de la main	:LA
comme punaise	:LA
comme un lapin pris dans les phares	:LA:i
comme un pet sur une plaque de verglas	:LA:s
comme un pet sur une toile cirée	:LA:s
comme un poisson dans l’eau	:LA:s
comme un singe en hiver	:LA
comme un sou neuf	:LA:e:s
comme une poule qui a trouvé un couteau	:LA
commis d’office	:LA:m
con comme la lune	:LA
con comme ses pieds	:LA
con comme un balai	:LA:m:s
con comme un balai sans manche	:LA
con comme un gland	:LA
con comme un manche	:LA:m:s
con comme une bite	:LA:m:s
con comme une chaise	:LA
con comme une valise sans poignée	:LA:m:s
connexe par arcs	:LA:s
connexes par arcs	:LA:p
connu comme le loup blanc	:LA:m:s
cons comme des balais	:LA:m:p
cons comme des manches	:LA:m:p
cons comme une bite	:LA:m:p
cons comme une valise sans poignée	:LA:m:p
contra legem	:LA/L
contraint et forcé	:LA:m:s
contre nature	:LA:i
copain comme cochon	:LA:m:s
copains comme cochons	:LA:m:p
corvéable à merci	:LA:e:s
corvéables à merci	:LA:e:p
coucher héliaque	:LA:m:s
couchers héliaques	:LA:m:p
coude à coude	:LA:i
couleur café	:LA
couleur café au lait	:LA
couleur locale	:LA:e:s|:LN:f:s
couleurs locales	:LA:e:p|:LN:f:p
coup dans le nez	:LA
coup de poing	:LA:s|:LN:m:s
coups de poing	:LA:p|:LN:m:p
courageux mais pas téméraire	:LA:m:s
courageux mais pas téméraires	:LA:m:p
couronné de succès	:LA:m:s
court courrier	:LA:e:s|:LN:m:s
court courriers	:LA:e:p|:LN:m:p
cousu de fil blanc	:LA:m:s
cousus de fil blanc	:LA:m:p
créole guadeloupéen	:LA:m
cri des bois	:LA:e|:LN:m
cri des marais	:LA:e|:LN:m
cri des plaines	:LA:e|:LN:m
croix processionnaire	:LA:f:s
croix processionnaires	:LA:f:p
cubique à faces centrées	:LA:s|:LN:m:s
cubique centré	:LA:m:s|:LN:m:s
cubiques à faces centrés	:LA:p|:LN:m:p
cubiques centrés	:LA:m:p|:LN:m:p
cucu la praline	:LA:i
cucul la noisette	:LA|:LN:m
cucul la praline	:LA:i
cucul la rainette	:LA
cuit dur	:LA:s
cuits durs	:LA:p
cul-cul la praline	:LA
cul serré	:LA:m:s
culcul la praline	:LA
culs serrés	:LA:m:p
curieux comme des chats	:LA:m:p
curieux comme un chat	:LA:m:s
d’avant	:LA:i
d’avant-garde	:LA
d’enfer	:LA:e:i
d’heureuse mémoire	:LA
d’honneur	:LA
d’ma coin	:LA:i
d’occasion	:LA
d’origine	:LA
d’un autre âge	:LA
d’un seul bloc	:LA:i
d’un seul tenant	:LA:i
déçu en bien	:LA:m:s
déçus en bien	:LA:m:p
dénombrable à l’infini	:LA:s
dénombrables à l’infini	:LA:p
dai dai	:LA:i
dame auxilliatrice	:LA:f:s
dames auxilliatrices	:LA:f:p
dan brownesque	:LA:e:s
dan brownesques	:LA:e:p
dan brownien	:LA:m:s
dan browniens	:LA:m:p
dans œuvre	:LA:i
dans la merde	:LA
dans la peine	:LA
dans la poche	:LA
dans le besoin	:LA:i
dans le caca	:LA
dans le collimateur	:LA:i
dans le coup	:LA
dans le cours	:LA:e:i
dans le pipe	:LA
dans le plus simple appareil	:LA
dans le sac	:LA
dans les vapes	:LA
dans son jus	:LA:i
de bac à sable	:LA
de bas étage	:LA
de bas bord	:LA
de bazar	:LA
de bistrot	:LA
de bon aloi	:LA
de bon ton	:LA
de bonne famille	:LA:e:i
de bonne guerre	:LA:i
de bonne prise	:LA:i
de bonne volonté	:LA:i
de cœur	:LA:e:i
de cape et d’épée	:LA:i
de charme	:LA
de comptoir	:LA
de confiance	:LA
de convention	:LA:i
de couleur	:LA:i
de derrière les fagots	:LA
de distinction	:LA:e
de fatigue	:LA
de fortune	:LA
de france et de navarre	:LA:i
de haut bord	:LA
de haut parage	:LA:e:i
de haut vol	:LA:e:i
de haute volée	:LA
de la même farine	:LA:i
de la même veine	:LA
de la plus belle eau	:LA
de la plus haute volée	:LA
de l’ère commune	:LA:i
de l’ère vulgaire	:LA:i
de ligne	:LA:i
de longue date	:LA:i
de mûre	:LA
de même farine	:LA:i
de malheur	:LA:e
de mauvais poil	:LA
de mes deux	:LA:i
de minimis	:LA
de mise	:LA:s
de mises	:LA:p
de neuf	:LA
de notre ère	:LA
de pacotille	:LA
de pièces et de morceaux	:LA
de plaisance	:LA:i
de première	:LA
de printemps	:LA:i
de quatre sous	:LA
de rien du tout	:LA
de rigueur	:LA:i
de sac et de corde	:LA:i
de second ordre	:LA
de seconde zone	:LA
de secours	:LA
de souche	:LA:e:i|:LN:e:i
de tous les diables	:LA:i
de tout poil	:LA:i
de tout repos	:LA:i
de toute beauté	:LA
de trois quarts	:LA
deg hit’an	:LA:m:s|:LN:m
deg hit’ans	:LA:m:p
dernier cri	:LA:e|:LN:m:s
dernier modèle	:LA
des familles	:LA
deux étoiles	:LA:i|:LN:m:i
deux de tens	:LA:e:i|:LN:e:i
deux de tens’	:LA:e:i|:LN:e:i
deux de tense	:LA:e:i|:LN:e:i
deux de tension	:LA|:LN:e:i
deux peccable	:LA:s
deux peccables	:LA:p
diésel électrique	:LA:e:s|:LN:m:s
diésels électriques	:LA:e:p|:LN:m:p
diable de	:LA:s
diables de	:LA:p
diesel électrique	:LA:e:s|:LN:m:s
diesels électriques	:LA:e:p|:LN:m:p
digne de ce nom	:LA:e:s
dignes de ce nom	:LA:e:p
divers et varié	:LA:m:s
divers et variés	:LA:m:p
donnant donnant	:LA:i|:LN:m:i
dos nu	:LA:e:i|:LN:m:i
drôle de	:LA:e:s
drôles de	:LA:e:p
dressé au poil et à la plume	:LA:s
dressés au poil et à la plume	:LA:p
droit comme un cierge	:LA
droit comme un i	:LA:m:s
droit comme un piquet	:LA
droit comme une épée	:LA:m:s
droit de l’hommiste	:LA:e:s
droit de l’hommistes	:LA:e:p
droits comme un i	:LA:m:p
du coin	:LA:i
du dernier cri	:LA:e
du diable	:LA:i
du dimanche	:LA
du lard ou du cochon	:LA:i
du même acabit	:LA
du même avis	:LA
du même tonneau	:LA:i
dur à cuire	:LA:m:s
dur à la détente	:LA:m:s
dur d’oreille	:LA:m:s
dur de la feuille	:LA:m:s
durs à cuire	:LA:m:p
durs à la détente	:LA:m:p
durs d’oreille	:LA:m:p
durs de la feuille	:LA:m:p
dusun malang	:LA:m|:LN:m
dusun papar	:LA:m|:LN:m
en échelle	:LA
en épingle à cheveux	:LA
en étant	:LA
en attente	:LA
en beau fusil	:LA
en bon état de marche	:LA
en bonne voie	:LA:i
en cannelle	:LA:i
en capilotade	:LA
en carafe	:LA
en carte	:LA
en chaîne	:LA
en chair et en os	:LA
en chaleur	:LA:i
en chambre	:LA
en cheveux	:LA
en cheville	:LA:e:s
en chevilles	:LA:e:p
en chien	:LA:m:s
en cloque	:LA
en coin	:LA:i
en compote	:LA
en costume d’ève	:LA:f
en costume d’adam	:LA:m
en cours	:LA
en dessous de la ceinture	:LA
en dessous de tout	:LA:e:i
en encorbellement	:LA:i
en enfilade	:LA:e:i
en friche	:LA
en gésine	:LA:f:i
en goguette	:LA
en herbe	:LA
en huit	:LA:i
en laisse	:LA
en lame de couteau	:LA:e:i
en manque	:LA
en marche	:LA:i
en mode duplex	:LA
en nid d’abeille	:LA:e:s
en odeur de sainteté	:LA
en option	:LA:i
en panne	:LA:i
en parfaite santé	:LA
en partance	:LA:i
en partie double	:LA
en peau de lapin	:LA:i
en phase	:LA
en pleine santé	:LA
en privé	:LA
en question	:LA:i
en queue de comète	:LA
en règle	:LA:i
en rang d’oignon	:LA
en rideau	:LA:i
en rumeur	:LA
en rupture de ban	:LA:e:i
en salle	:LA
en sous-équipage	:LA:e:i
en tenue d’ève	:LA:f:i
en tire-bouchon	:LA
en train	:LA
en usine	:LA
en vacance	:LA
en vie	:LA
en vigueur	:LA
en vue	:LA:i
entre deux tailles	:LA
entre le zist et le zest	:LA
entre quatre murs	:LA
ex ante	:LA:i/L
ex parte	:LA
explosé de rire	:LA:m:s
explosés de rire	:LA:m:p
facile à vivre	:LA:e
fagoté comme l’as de pique	:LA:m:s
faisceau syndesmo-pharyngien	:LA:m:s
faisceaux syndesmo-pharyngiens	:LA:m:p
fait à cœur	:LA:m:s
fait exprès	:LA:i|:LN:m
fait maison	:LA:m:s|:LN:m
faits à cœur	:LA:m:p
fauché comme les blés	:LA
faux derche	:LA:e:s|:LN:e:s
faux derches	:LA:e:p|:LN:e:p
faux jeton	:LA:e:s|:LN:e:s
faux jetons	:LA:e:p|:LN:e:p
ferblantier mouliste	:LA
fermentation lactique	:LA:e:s
fermentations lactiques	:LA:e:p
ferré à droite	:LA
ferré à gauche	:LA
ferré à glace	:LA:m:s
ferrés à glace	:LA:m:p
fièvres méningo-gastriques	:LA
fiché s	:LA|:LN
fier comme artaban	:LA
fier comme harpagon	:LA
fier comme un bar-tabac	:LA:m
fier comme un coq	:LA:m:s
fier comme un p’tit banc	:LA
fier comme un paon	:LA:m:s
fier comme un pou	:LA:m:s
fin comme du gros sel	:LA
fin comme l’ambre	:LA
fin de course	:LA|:LN
fin de race	:LA|:LN:f:s
flambant neuf	:LA:m:s
flambant neufs	:LA:m:p
fleur bleue	:LA
fort comme un turc	:LA:m
fort de café	:LA:i
fort des halles	:LA:m
fort en thème	:LA:m|:LN:m
fou à enfermer	:LA:s
fou à lier	:LA:m:s
fou comme de la marde	:LA
fou comme un balai	:LA
fou furieux	:LA:m:s|:LN:m:s
fous à enfermer	:LA:p
fous à lier	:LA:m:p
fous furieux	:LA:m:p|:LN:m:p
frais émoulu	:LA:m:s
frais émoulus	:LA:m:p
frais comme un gardon	:LA:m:s
frais et dispos	:LA
franc de pied	:LA:m:s
franc du collier	:LA:m:s
france au revoir	:LA:i
francs de pied	:LA:m:p
francs de port	:LA:m:p
francs du collier	:LA:m:p
free to play	:LA:m
froid comme un nez de chien	:LA:m:s
froids comme des nez de chien	:LA:m:p
gününa yajich	:LA:e|:LN:m:s
gai comme le canal	:LA:m:s
gai comme un pinson	:LA:m:s
gaie comme une pinsonne	:LA
garanti sur facture	:LA:s
garantis sur facture	:LA:p
gnan gnan	:LA
golden shaded	:LA|:LN:m
gonflé à la testostérone	:LA:m:s
gonflés à la testostérone	:LA:m:p
grand ouvert	:LA:m:s
grand public	:LA:s|:LN:m
grande gueule	:LA:f:s|:LN:f:s
grandes gueules	:LA:f:p|:LN:f:p
grandeur nature	:LA:i|:LN
grands mottois	:LA:m:p
grands ouverts	:LA:m:p
grands publics	:LA:p
gras comme un cent de clous	:LA
gras comme un loukoum	:LA:m:s
gras comme un moine	:LA:m:s
gravé dans le marbre	:LA:m:s
gravé en lettres d’or	:LA:m:s
gravé en lettres de feu	:LA:m:s
gravés dans le marbre	:LA:m:p
gravés en lettres d’or	:LA:m:p
gravés en lettres de feu	:LA:m:p
grièvement blessé	:LA:m:s
gris souris	:LA
gros comme le bras	:LA:i
gros comme une maison	:LA
gros comme une noisette	:LA:m
gueux comme un rat d’église	:LA:m:s
habile à succéder	:LA:e
hardi à	:LA
haut à la main	:LA:m
haut comme trois pommes	:LA:m:s
haut de gamme	:LA:i|:LN:m:i
haut en couleur	:LA:m:s
haut justicier	:LA:s|:LN:m:s
haut monté	:LA:m:s
haut placé	:LA:m:s
haut placés	:LA:m:p
haut sur cravate	:LA:m:s
haut tanana	:LA:m:s|:LN:m
haut tananas	:LA:m:p
haute en couleur	:LA
haute naissance	:LA:s
hautes naissances	:LA:p
hauts comme trois pommes	:LA:m:p
hauts justiciers	:LA:p|:LN:m:p
heureux comme des princes	:LA:m:p
heureux comme dieu en france	:LA
heureux comme un prince	:LA:m:s
high tech	:LA:i
horribile auditu	:LA:i/L
horribile visu	:LA:i/L
hors cadre	:LA:s
hors cadres	:LA:p
hors concours	:LA
hors d’œuvre	:LA:m
hors d’haleine	:LA
hors d’usage	:LA:i
hors de pair	:LA:i
hors de portée	:LA
hors de soi	:LA
hors du commun	:LA:e:i
hors du cours	:LA
hors faute	:LA
hors les murs	:LA:i
hors ligne	:LA:e:i
hors norme	:LA:e:i
hors normes	:LA:i
hors pair	:LA:i
hors piste	:LA:e|:LN:m
hors rang	:LA
hors sac	:LA:e|:LN:m
hors sujet	:LA:i
hors taxe	:LA
hors taxes	:LA
idiot de	:LA:s
idiots de	:LA:p
imagerie par résonance magnétique	:LA:f:s
imageries par résonance magnétique	:LA:f:p
in 4º	:LA:e:i|:LN:m:i
in 8vo	:LA:e:i|:LN:m:i
in partibus	:LA:i
in partibus infidelium	:LA/L
in sedecimo	:LA:e:i|:LN:m:i
in situ	:LA:i/L
in solidum	:LA
in utero	:LA/L
inconnu au bataillon	:LA:m:s
inconnus au bataillon	:LA:m:p
incurieux de	:LA
index expurgatoire	:LA
inférieur ou égal	:LA
infirme moteur cérébral	:LA:e:m:s|:LN:e:m:s
innocent comme l’agneau qui vient de naître	:LA:m:s
intérêts moratoires	:LA:m:p
ivre de sang	:LA:e:s
ivre mort	:LA:m:s
ivres de sang	:LA:e:p
ivres morts	:LA:m:p
jaloux comme un tigre	:LA:m:s
jaune citron	:LA:i|:LN:i
jaune moutarde	:LA:m|:LN:m
jaune paille	:LA:i|:LN:i
jour chez soi	:LA
jour ouvré	:LA:m:s
jours ouvrés	:LA:m:p
judicatum solvi	:LA:e:i|:LN:m:i
jus vert et verjus	:LA
jus vert ou verjus	:LA
kelabit bario	:LA:m|:LN:m
kif-kif bourricot	:LA
la laigniens	:LA:m:p
laid comme les sept péchés capitaux	:LA:m:s
laid comme un pou	:LA:m:s
laids comme des poux	:LA:m:p
laids comme les sept péchés capitaux	:LA:m:p
large d’esprit	:LA:e
larron comme une pie	:LA:m:s
last minute	:LA:e:s|:LN:m:s
last minutes	:LA:e:p|:LN:m:p
latin médiéval	:LA:s|:LN:m:s
latins médiévaux	:LA:p
le cœur sur la main	:LA:i
le fun	:LA:i
lebu’kulit	:LA:m:s|:LN:m
lebu’kulits	:LA:m:p
levé du pied gauche	:LA:m:s
libre comme l’air	:LA
libre de	:LA:e:s
libre penseur	:LA:m:s|:LN:m:s
libres de	:LA:e:p
libres penseurs	:LA:m:p|:LN:m:p
localement compact	:LA:m:s
localement connexe	:LA:e:s
localement connexe par arcs	:LA:s
localement connexes	:LA:e:p
localement connexes par arcs	:LA:p
localement convexe	:LA:e:s
localement convexes	:LA:e:p
localement fini	:LA
localement truc	:LA:i
long à la détente	:LA:m:s
long comme un jour sans pain	:LA
louis xiv	:LA:i
lourd de sens	:LA
low cost	:LA:m|:LN:m
ma pnaan	:LA:m|:LN:m
maître de soi	:LA:e:s
maîtres d’eux-mêmes	:LA:e:p
made in	:LA
made in france	:LA:i|:LN:m
maigre comme un clou	:LA:e
maigre comme un coucou	:LA:e:s
maigre comme une ételle	:LA:e:s
maigres comme des ételles	:LA:e:p
maigres comme des coucous	:LA:e:p
majeur et vacciné	:LA:m:s
mal à l’aise	:LA:i
mal élevé	:LA:m:s
mal élevés	:LA:m:p
mal bâti	:LA:m:f:p
mal barré	:LA:m:s
mal blanchi	:LA:m:f:p
mal coiffé	:LA
mal dégrossi	:LA:m:s
mal embouché	:LA:m:s
mal en point	:LA:i
mal famé	:LA:m:s
mal famés	:LA:m:p
mal léché	:LA:m:s
mal luné	:LA:m:s
malade comme un chien	:LA:e
malade des nerfs	:LA
malade mental	:LA|:LN
malheureux comme les pierres	:LA:m
malin comme un singe	:LA
mangé aux mites	:LA
manobo agusan	:LA:m:s|:LN:m
manobo agusans	:LA:m:p
manobo de cotabato	:LA:m|:LN:m
manobo de sarangani	:LA:m|:LN:m
maquillé comme un camion volé	:LA:m:s
maquillés comme un camion volé	:LA:m:p
marais chapelains	:LA:m:p
marchand de vin	:LA|:LN:m:s
mauvaise langue	:LA:e:s|:LN:f:s
mauvaises langues	:LA:e:p|:LN:f:p
meilleur marché	:LA:e:i
mi-ange mi-démon	:LA
mi-chèvre mi-chou	:LA
mi-figue mi-raisin	:LA:e:i
miwok de la côte	:LA:m:s|:LN:m:s
miwok des plaines	:LA:e:s|:LN:m:s
miwok du lac	:LA:e:s|:LN:m:s
miwok méridional de la sierra	:LA|:LN:m:s
miwoks de la côte	:LA:m:p
miwoks des plaines	:LA:e:p
miwoks du lac	:LA:e:p
modern style	:LA:i|:LN:m:i
moins que rien	:LA:i|:LN:e:i
mois dracontique	:LA:m
monté haut	:LA:m
montagnards divins	:LA:m:p
montoux colasiens	:LA:m:p
mori atas	:LA:m|:LN:m
mori bawah	:LA:m:s|:LN:m
mori bawahs	:LA:m:p
mort de fatigue	:LA
mort de rire	:LA:m:s
mort et enterré	:LA:m:s
mort les armes à la main	:LA:m:s
mort pour la france	:LA:m|:LN:m
morts de rire	:LA:m:p
mou du bulbe	:LA:m:s|:LN:m:s
mou du genou	:LA:m:s|:LN:m:s
mous du bulbe	:LA:m:p|:LN:m:p
mous du genou	:LA:m:p|:LN:m:p
muet comme un francolin pris	:LA:m:s
muet comme un poisson	:LA:m:s
muet comme un sphinx	:LA:m:s
muet comme une carpe	:LA:m:s
muet comme une tombe	:LA:m:s
multa paucis	:LA/L
murut bookan	:LA:m|:LN:m
murut nabaay	:LA:m|:LN:m
murut paluan	:LA:m|:LN:m
murut selungai	:LA:m|:LN:m
murut sembakung	:LA:m|:LN:m
murut tagol	:LA:m|:LN:m
murut timugon	:LA:m|:LN:m
myope comme une taupe	:LA:e:s
myopes comme des taupes	:LA:e:p
né sous une bonne étoile	:LA:m:s
né sous une mauvaise étoile	:LA:m:s
net de	:LA:m:s
net de réserve	:LA
new look	:LA:i
nez à nez	:LA
ngaju dayak	:LA:m:s|:LN:m
ngaju dayaks	:LA:m:p
ni fait ni à faire	:LA
ni figue ni raisin	:LA
nickel chrome	:LA:i
noir animal	:LA:m|:LN:m
noir comme dans la gueule du loup	:LA:m
noir comme dans le cul d’une nonne	:LA
noir comme dans un four	:LA
noir d’encre	:LA:m|:LN:m
noir d’ivoire	:LA:m|:LN:m
noir de jais	:LA:m|:LN:m
noir de monde	:LA:m:s
noir et blanc	:LA:i|:LN:m:s
noirs de monde	:LA:m:p
non ædificandi	:LA:e
non aedificandi	:LA:e/L
non arrondi	:LA:m:s
non avenu	:LA:m:s
non avenus	:LA:m:p
non conventionnel	:LA:m:s
non conventionnels	:LA:m:p
non coupable	:LA:s
non coupables	:LA:p
non dénombrable	:LA:e:s
non dénombrables	:LA:e:p
non dense	:LA:e:s
non denses	:LA:e:p
non disponible	:LA:e:s
non disponibles	:LA:e:p
non ferreux	:LA
non marqué	:LA:m:s
non occidental	:LA:m:s
non périodique	:LA:e:s
non périodiques	:LA:e:p
non stéroïdien	:LA:m:s
non stéroïdiens	:LA:m:p
normalement blanc	:LA:m:s
normalement noir	:LA:m:s
nourri dans le sérail	:LA:m:s
nouvelle vague	:LA:i
nu comme des vers	:LA:m:s
nu comme un ver	:LA:m:s
nul à chier	:LA:m:s
nul de chez nul	:LA:m:s
nul et non avenu	:LA:m:s
nulle part dense	:LA:e:s
nulle part denses	:LA:e:p
nuls à chier	:LA:m:p
nuls de chez nul	:LA:m:p
nuls et non avenus	:LA:m:p
numéro un	:LA:e|:LN:e
off shore	:LA:e:i
olé olé	:LA:i
oma longh	:LA:m:s|:LN:m
oma longhs	:LA:m:p
one shot	:LA:s
one shots	:LA:p
open source	:LA:e:i|:LN:m:i
or blanc	:LA:i|:LN:m:s
or gris	:LA:i|:LN:m:s
or jaune	:LA:i|:LN:m:s
or pâle	:LA:m:s
or rose	:LA:i|:LN:m:s
or vert	:LA|:LN:m
or vert pâle	:LA:m:s
pâle comme un linge	:LA:s
pâle comme un mort	:LA:s
pâles comme des morts	:LA:p
pâles comme un linge	:LA:p
pédé comme un grec	:LA
pété comme un coin	:LA:m:s
pété comme un coing	:LA:m:s
pété comme un petit lu	:LA
pété de rire	:LA:m:s
pété de thunes	:LA:m:s
pétés comme un coing	:LA:m:p
pétés de rire	:LA:m:p
pétés de thunes	:LA:m:p
pairement pair	:LA:m:s
papier bulle	:LA:i|:LN:m:s
par alliance	:LA:i
par le sang	:LA
par petites tables	:LA
paré comme une châsse	:LA
partagé en deux	:LA:m:s
partes extra partes	:LA
pas catholique	:LA
pas glop	:LA:i
pas joli joli	:LA:m:s
pas jolis jolis	:LA:m:p
pas mal de sa personne	:LA:e
pas pire	:LA
pas possibles	:LA:e:p
passé date	:LA:m:s
pauvre comme job	:LA
pauvre comme la gale	:LA
pauvre de	:LA
pauvre en graisse	:LA
payable à lettre vue	:LA:s
payable à vue	:LA:s
payables à lettre vue	:LA:p
payables à vue	:LA:p
peinture rupestre	:LA:m
pelleteux de nuages	:LA|:LN:m
penan benalui	:LA:m|:LN:m
persona gratissima	:LA:i
persona non grata	:LA:i/L
peso grosso	:LA|:LN:m
petits pressignois	:LA:m:p
peureux comme un lièvre	:LA
piège à clics	:LA:s
pièges à clics	:LA:p
pipi de chat	:LA:e:s|:LN:m:s
pipis de chat	:LA:e:p|:LN:m:p
place beauvau	:LA:i
plat comme une limande	:LA
plat comme une planche à pain	:LA:m:f
plat comme une punaise	:LA
plate comme une planche à pain	:LA
plates comme une planche à pain	:LA
plats comme une planche à pain	:LA
plein à craquer	:LA:m:s
plein aux as	:LA:m:s|:LN
plein cintre	:LA|:LN:m
plein comme un œuf	:LA
plein de vie	:LA:m:s
plein et entier	:LA:m:s
pleins aux as	:LA:m:p
pleins de vie	:LA:m:p
pleins et entiers	:LA:m:p
plié de rire	:LA:m:s
plié en quatre	:LA:m:s
pliés de rire	:LA:m:p
plug and play	:LA
plus con que la moyenne	:LA:m:s
plus d’un	:LA:s
plus facile à dire qu’à faire	:LA
plus grand que nature	:LA
plus mort que vif	:LA:m:s
point à point	:LA|:LN:m
poire sauvage	:LA:f:s
poires sauvages	:LA:f:p
poivre et sel	:LA:e
politiquement correct	:LA:m:s|:LN:m:s
politiquement corrects	:LA:m:p|:LN:m:p
politiquement incorrect	:LA|:LN:m
porté disparu	:LA:m:s
porté sur la créature	:LA:m:s
porté sur l’article	:LA
portés disparus	:LA:m:p
post-11 septembre	:LA:i
post 11 septembre	:LA:i
post mortem	:LA:e:s/L
post mortems	:LA:e:p/L
pourri gâté	:LA:m:s
pourrie gâtée	:LA:f:s
près de ses cennes	:LA
près de ses sous	:LA
premier du nom	:LA:s
premiers du nom	:LA:p
premiers entre eux	:LA:m:p
presque sûr	:LA:m:s
presque surs	:LA:m:p
pris de court	:LA
pro forma	:LA/L
promis et juré	:LA
promis juré	:LA:i
promis, juré, craché	:LA:i
propos d’antichambre	:LA:e
propre à	:LA:e:s
propre sur soi	:LA
proprement dit	:LA:m:s
proprement dits	:LA:m:p
prout iacet	:LA:i
prout prout	:LA:e
prout, ma chère	:LA
punan merap	:LA:m|:LN:m
punan tubu’	:LA:m|:LN:m
pur beurre	:LA:i
pur et dur	:LA:m:s|:LN:m:s
pur et simple	:LA:m:s
pur jus	:LA:i
pur sucre	:LA:i
pure laine	:LA|:LN:f
pure souche	:LA
purs et durs	:LA:m:p|:LN:m:p
putain comme chausson	:LA:s
putains comme chaussons	:LA:p
putains de	:LA:p
quai d’orsay	:LA:i
quarante et un	:LA|:LN:m
quart d’onde	:LA:i
quart de place	:LA:i|:LN:m
quatre nages	:LA:i
quatre par quatre	:LA|:LN:m
quel qu’il fût	:LA:m:s
quel qu’il soit	:LA:m:s
quels qu’ils fussent	:LA:m:p
quels qu’ils soient	:LA:m:p
qui se courent après	:LA:m
qui se respecte	:LA:e:s
qui se respectent	:LA:e:p
qui va bien	:LA:s
régional de l’étape	:LA:m:s
radio piloté	:LA:m
raide comme la justice	:LA
raide comme un passe-lacet	:LA:s
raides comme un passe-lacet	:LA:p
rangé des voitures	:LA:m:s
rapide comme l’éclair	:LA
rapide comme un serpent	:LA
ras la touffe	:LA:i
ravitaillé par les corbeaux	:LA:m:s
ravitaillés par les corbeaux	:LA:m:p
rejang kayan	:LA:m:s|:LN:m
rejang kayans	:LA:m:p
relativement compact	:LA:m
riche à millions	:LA:s
riche comme crésus	:LA
riches à millions	:LA:p
rond comme une queue de pelle	:LA
rose cerise	:LA:m|:LN:m
rouge cerise	:LA:m|:LN:m
rouge comme un coq	:LA:s
rouge comme une pivoine	:LA
rouge comme une tomate	:LA
rouge danois	:LA:m:s|:LN:m:s
rouge danoise	:LA:f:s|:LN:f:s
rouge sang	:LA:e:i|:LN:m:s
rouges comme des coqs	:LA:p
rusé comme un renard	:LA:m
rusé comme un singe	:LA:m:s
rusés comme des singes	:LA:m:p
russes blancs	:LA:m:p
sûr et certain	:LA:m:s
sûrs et certains	:LA:m:p
sérieux comme un pape	:LA:m
sage comme une image	:LA:e:s
sages comme des images	:LA:e:p
sain et sauf	:LA:m:s
sains et saufs	:LA:m:p
saint-vincentais et grenadins	:LA:m:p
sale comme un cochon	:LA:e
sale comme un peigne	:LA
sale comme une huppe	:LA:m:p
sama méridional	:LA:m:s|:LN:m
sama méridionals	:LA:m:p
sama pangutaran	:LA:m:s|:LN:m
sama pangutarans	:LA:m:p
sans égal	:LA
sans alcool	:LA
sans allure	:LA|:LN:e
sans appel	:LA:i
sans aveu	:LA
sans dessein	:LA:i|:LN:e:i
sans différence	:LA
sans feu ni lieu	:LA
sans fil	:LA:i
sans foi ni loi	:LA
sans haleine	:LA
sans histoire	:LA
sans lendemain	:LA
sans merci	:LA
sans pareil	:LA:m:s
sans pareils	:LA:m:p
sans peur et sans reproche	:LA
sans précédent	:LA
sans queue ni tête	:LA
sans réservation	:LA
sans scrupules	:LA
sans un	:LA
sans valeur	:LA:i
sans vergogne	:LA
sans voix	:LA|:LN:e
saoul comme un cochon	:LA:m:s
saoul comme un polonais	:LA:m
sapé comme un milord	:LA:m:s
satisfait ou remboursé	:LA:m:s
satisfaits ou remboursés	:LA:m:p
saute au paf	:LA:i
sec comme du brésil	:LA
semper virens	:LA:i|:LN:m:i
silver shaded	:LA|:LN:m
simple comme bonjour	:LA
simple d’esprit	:LA|:LN:e
sine qua non	:LA:e/L
sine quâ non	:LA:e/L
six pieds sous terre	:LA:e:i
sobre comme un chameau	:LA:s
sobres comme des chameaux	:LA:p
solide comme un roc	:LA:e:s
solides comme un roc	:LA:e:p
sorti de l’auberge	:LA:m:s
sortis de l’auberge	:LA:m:p
sot et grenu	:LA:m:s
sots et grenus	:LA:m:p
soul comme toute la pologne	:LA
soul comme un cochon	:LA
soul comme un polonais	:LA:m
soupe au lait	:LA:i
sourd comme un pot	:LA
sous la main de la justice	:LA
sous la main de l’autorité	:LA
sous la main et autorité de justice	:LA
sous l’eau	:LA
sous les ordres	:LA
sous main de justice	:LA
sous perfusion	:LA:i
sous pression	:LA:i
sous tension	:LA:i
sous x	:LA:i
stéphanois fontbelliniens	:LA:m:p
strictement inférieur	:LA:m:s
strictement négatif	:LA:m:s
strictement négatifs	:LA:m:p
strictement positif	:LA:m:s
strictement positifs	:LA:m:p
strictement supérieur	:LA:m:s
supérieur ou égal	:LA
sur la paille	:LA:e:i
sur la réserve	:LA
sur le cul	:LA
sur le tout du tout	:LA:i
sur pied	:LA
tête de mule	:LA|:LN:f:s
tête de nègre	:LA:i|:LN:f:s
tête en l’air	:LA:i|:LN:m:f
têtu comme un âne	:LA:m:s
têtu comme une bourrique	:LA
têtu comme une mule	:LA:m
tactile multipoint	:LA:e:s|:LN:m:i
tactile multipoints	:LA:e:p
talon rouge	:LA|:LN:m
tarte à la crème	:LA:f|:LN:f:s
taux du prêt marginal	:LA:m
tel quel	:LA:m:s
tels quels	:LA:m:p
tendu comme un string	:LA:m:s
tendus comme un string	:LA:m:p
tepehua de huehuetla	:LA:m|:LN:m:s
timbré sur commande	:LA|:LN:m:s
tindal dusun	:LA:m|:LN:m
tip top	:LA:e:i
tiré à quatre épingles	:LA:m:s
tiré au cordeau	:LA:s
tiré par les cheveux	:LA:m:s
tirés à quatre épingles	:LA:m:p
tirés au cordeau	:LA:p
tirés par les cheveux	:LA:m:p
tolérant aux pannes	:LA
tombé du camion	:LA:m:s
tombé du ciel	:LA
tombés du camion	:LA:m:p
torse nu	:LA:i
totonaque du haut necaxa	:LA:m|:LN:m
tous corps d’état	:LA
tout battant neuf	:LA
tout beau, tout neuf	:LA
tout de la gueule	:LA:i
tout fait	:LA:m:s
tout faits	:LA:m:p
tout feu tout flammes	:LA
tout le premier	:LA:m:s
tout mélangé	:LA:m
tout nouveau, tout beau	:LA
tout ouïe	:LA
tout prêt	:LA
tout sourire	:LA:i
tout terrain	:LA:e:i|:LN:m:i
très chrétien	:LA:m:s
tranquille comme baptiste	:LA
tranquille pépère	:LA
trente et unième	:LA:e:s|:LN:e:s
trente et unièmes	:LA:e:p|:LN:e:p
triste comme un bonnet de nuit	:LA
trois étoiles	:LA:i|:LN:m:i
trop beau pour être vrai	:LA:m:s
uma’lasan	:LA:m|:LN:m
un contre un	:LA:i|:LN:m:i
une étoile	:LA:i|:LN:m:i
urbi et orbi	:LA/L
vague d’étrave	:LA:f
vent debout	:LA:i|:LN:m
ventre de biche	:LA:i
vert bouteille	:LA:e|:LN:m
vert de gris	:LA:i|:LN:m:i
vert de jalousie	:LA:m:s
vert de peur	:LA:m:s
vert olive	:LA:e
vert pomme	:LA:i
verts de jalousie	:LA:m:p
vieil or	:LA:i|:LN:m:i
vieille france	:LA:i
vieux comme hérode	:LA
vieux comme le monde	:LA
vieux comme mes robes	:LA:m
vieux jeu	:LA:e:i
vieux nordique	:LA:s|:LN:m
vieux nordiques	:LA:p
vingt et unième	:LA:e:s
vingt et unièmes	:LA:e:p
vite fait bien fait	:LA
vite sur ses patins	:LA
vive l’armiste	:LA:e:s|:LN:e:s
vive l’armistes	:LA:e:p|:LN:e:p
voûte en berceau brisé	:LA:f:s
voûtes en berceau brisé	:LA:f:p
voleur comme une pie	:LA:m:s
voleurs comme des pies	:LA:m:p
vox inanis	:LA:m/L
wesh wesh	:LA:e:i|:LN:m:i
youkaguir de la kolyma	:LA:m:s|:LN:m:s
youkaguir de la toundra	:LA:m:s|:LN:m:s
youkaguirs de la toundra	:LA:m:p
