# Locutions prépositives

afin de	:LR
au beau milieu de	:LR
au bord de	:LR
au bout de	:LR
au bénéfice de	:LR
au bénéfice des	:LR
au bénéfice du	:LR
au contraire de	:LR:i
au cours de	:LR
au droit de	:LR
au détour de	:LR
au détriment de	:LR
au fil de	:LR
au fur de	:LR
au gré de	:LR
au hasard de	:LR
au lieu de	:LR
au lieu des	:LR
au lieu du	:LR
au lieu d’	:LR
au lieu et place de	:LR
au milieu de	:LR
au moment de	:LR
au moment où	:LR
au moyen de	:LR:i
au mépris de	:LR
au même titre que	:LR:i
au niveau de	:LR
au nom de	:LR
au nom du	:LR
au nom d’	:LR
au nombre de	:LR
au point de	:LR
au prix de	:LR
au profit de	:LR
au préjudice de	:LR
au prétexte de	:LR
au rebours de	:LR
au regard de	:LR
au rez de	:LR
au risque de	:LR
au sein de	:LR
au sein du	:LR
au sein d’	:LR
au sortir de	:LR
au spectacle de	:LR
au sujet de	:LR
au temps de	:LR
au titre de	:LR
au travers de	:LR
au voisinage de	:LR
au vu de	:LR
au vu et au su de	:LR
au vu et su de	:LR
au-dedans de	:LR:i
au-dessous de	:LR:i
auprès de	:LR
aussi peu que	:LR
autour de	:LR
aux bons soins de	:LR
aux dépens de	:LR
aux fins de	:LR
aux lieu et place de	:LR
aux portes de	:LR
aux trousses de	:LR
avant de	:LR
avant que de	:LR
bien loin de	:LR
cela supposé	:LR
compte tenu de	:LR
conformément à	:LR
conséquemment à	:LR
crainte de	:LR
dans la crainte de	:LR
dans la mesure de	:LR
dans le moment où	:LR
dans le moment que	:LR
dans le viseur de	:LR
dans l’optique de	:LR
de chez	:LR:i
de crainte de	:LR
de façon à	:LR
de la part de	:LR
de la part du	:LR
de la part d’	:LR
de l’ordre de	:LR
de l’ordre du	:LR
de l’ordre d’	:LR
de manière	:LR
de manière à	:LR
de mon côté	:LR
de niveau avec	:LR
de par	:LR
de parmi	:LR
de peur de	:LR
de préférence à	:LR
de sorte à	:LR
devant notaire	:LR
dieu sait	:LR
du milieu de	:LR
du temps que	:LR
du vivant de	:LR
défense de	:LR
défini sur	:LR
d’après	:LA:i|:LR
d’au milieu de	:LR
d’avec	:LR
d’entre	:LR
en amont de	:LR
en amont des	:LR
en amont du	:LR
en amont d’	:LR
en arrière de	:LR
en aval de	:LR
en aval des	:LR
en aval du	:LR
en aval d’	:LR
en avant de	:LR
en bas de	:LR
en ce qui concerne	:LR
en compagnie de	:LR:i
en comparaison de	:LR
en conformité de	:LR
en considération de	:LR
en conséquence de	:LR
en dehors de	:LR
en deçà de	:LR
en dépit de	:LR
en exécution de	:LR
en face de	:LR
en fait de	:LR
en fonction de	:LR
en fonction de	:LR
en fonction des	:LR
en fonction du	:LR
en forme de	:LR
en forme de	:LR
en forme d’	:LR
en guise de	:LR
en haine de	:LR
en haut de	:LR
en la personne de	:LR
en lieu et place de	:LR
en l’honneur de	:LR
en matière de	:LR
en mémoire de	:LR
en même temps que	:LR
en partant	:LR
en passant	:LR
en passe de	:LR
en place de	:LR
en plus de	:LR
en proie à	:LR
en proportion de	:LR
en présence de	:LR:i
en qualité de	:LR
en raison de	:LR
en regard de	:LR
en signe de	:LR
en suite de	:LR
en sus de	:LR
en termes de	:LR
en train de	:LR
en vertu de	:LR
en vue de	:LR
entenant de	:LR
entrain de	:LR
et de	:LR
eu égard à	:LR
face à	:LR
faute de	:LR
foi de	:LR
grâce à	:LR
grâces à	:LR
hors de	:LR
il est de fait que	:LR
il est possible que	:LR
il n’empêche que	:LR:i
il n’en reste pas moins que	:LR
il pourrait bien se faire que	:LR
il se pourrait que	:LR
il serait possible que	:LR
il y a	:LR
in illo tempore	:LR:i/L
jusques et y compris	:LR
jusques à	:LR
jusqu’à	:LR
jusqu’à concurrence de	:LR
le cul sur la commode	:LR
le diable soit de	:LR
le long de	:LR
le plus clair de	:LR
locution prépositive	:LN:f:s|:LR
loin de	:LR
lors de	:LR:i
mort à	*|:LR
non content de	:LR
non plus que	:LR
non sans	:LR:i
par certains côtés	:LR:i
par comparaison à	:LR
par crainte de	:LR
par devers	:LR
par l’intermédiaire de	:LR
par manière de	:LR
par manque de	:LR
par opposition à	:LR
par préférence à	:LR
par rapport à	:LR
par suite de	:LR
pas de	:LR
pas la peine de	:LRv
pas plus que	:LR
pas plus tard que	:LR
pour autant que	:LR
pour ce qui est de	:LR
pour comble de	:LR
pour le compte de	:LR
pour tous	:LR:m:p
pour tout	:LR:m:s
pour un peu	:LR
proche de	:LR
près de	:LR
préalablement à	:LR
prêt à	:LRv
quant aux	:LR
quant à	:LR
quel que soit	:LR:m:s
quelle que soit	:LR:f:s
quelles que soient	:LR:f:p
quels que soient	:LR:m:p
quoi qu’il en fût	:LR
relativement à	:LR
rien moins que	:LR
rien que	:LR
sans parler de	:LR
sans plus de	:LR
sans pour autant	:LR
sans préjudice de	:LR
sans quoi	:LR
sauf à	:LR
si peu que	:LR
sous couleur de	:LR
sous couvert de	:LC|:LR
sous forme de	:LR
sous la coupe de	:LR
sous la houlette de	:LR
sous la plume de	:LR
sous le coup de	:LR
sous le couvert de	:LR
sous le prétexte de	:LR
sous le rapport de	:LR
sous les auspices de	:LR
sous les yeux de	:LR
sous l’ombre de	:LR
sous peine de	:LR
sous prétexte de	:LR
sous réserve de	:LC|:LR
suite à	:LR
supposé que	:LR
sur le compte de	:LR
sur le coup de	:LR
sur le dos de	:LR
sur le pied de	:LR
sur le plan	:LR
sur le point de	:LR
sus le sujet de	:LR
s’agissant de	:LR
tant et si bien que	:LR
tant qu’à	:LR
va pour	:LR
vent debout contre	:LR
vis-à-vis de	:LR
y compris	:LR:i
à bas de	:LR
à base de	:LR
à base d’	:LR
à bout de	:LR
à cause de	:LR
à cet égard	:LR
à charge de	:LR
à compter de	:LR
à concurrence de	:LR
à condition de	:LR
à coup de	:LR
à côté de	:LR
à dessein de	:LR:i
à destination de	:LR
à défaut de	:LR
à fin de	:LR
à fleur de	:LR
à force de	:LR
à grand renfort de	:LR
à hauteur de	:LR
à la condition de	:LR
à la différence de	:LR
à la faveur de	:LR
à la honte de	:LR
à la lumière de	:LR
à la lumière des	:LR
à la lumière du	:LR
à la lumière d’	:LR
à la manière de	:LR
à la manière des	:LR
à la manière d’	:LR
à la merci de	:LR
à la mémoire de	:LR
à la place de	:LR
à la réserve de	:LR
à la sortie de	:LR
à la suite de	:LR
à la tête de	:LR
à la vue de	:LR
à l’abri de	:LR
à l’adresse de	:LR
à l’aide de	:LR
à l’appui de	:LR
à l’attention de	:LR
à l’aulne de	:LR
à l’aune de	:LR
à l’effet de	:LR
à l’encontre de	:LR
à l’endroit de	:LR
à l’entour de	:LR:i
à l’envi de	:LR
à l’exception de	:LR
à l’exclusion de	:LR
à l’exemple de	:LR
à l’extérieur de	:LR:i
à l’imitation de	:LR
à l’instar de	:LR
à l’insu de	:LR
à l’intention de	:LR
à l’intérieur de	:LR:i
à l’issue de	:LR
à l’occasion de	:LR
à l’ombre de	:LR
à l’opposé de	:LR
à l’égal de	:LR
à l’égard de	:LR
à l’épreuve de	:LR
à mesure de	:LR
à partir de	:LR
à peine de	:LR:i
à proportion de	:LR
à propos de	:LR
à raison de	:LR
à rebours de	:LR
à titre de	:LR
à travers	:LR
à valeurs dans	:LR
à voir	:LR
étant donné	:LR:i
mis comme	:LR

__END__

du chef de	:LW
putain de	:LA:s|:LW
taille de	:LW
